UF;CODUF;CODMUNIC;NOMEMUNIC;POP.COLETATADA;POP.IMPUTADA;POP.TOTAL
RO;11;00015;Alta Floresta D'Oeste;20875;620;21495
RO;11;00023;Ariquemes;93006;3827;96833
RO;11;00031;Cabixi;5121;242;5363
RO;11;00049;Cacoal;84930;1965;86895
RO;11;00056;Cerejeiras;15297;593;15890
RO;11;00064;Colorado do Oeste;14962;701;15663
RO;11;00072;Corumbiara;7164;355;7519
RO;11;00080;Costa Marques;12511;116;12627
RO;11;00098;Espigão D'Oeste;28166;1231;29397
RO;11;00106;Guajará-Mirim;39080;306;39386
RO;11;00114;Jaru;48396;2195;50591
RO;11;00122;Ji-Paraná;119713;4620;124333
RO;11;00130;Machadinho D'Oeste;30321;386;30707
RO;11;00148;Nova Brasilândia D'Oeste;15414;265;15679
RO;11;00155;Ouro Preto do Oeste;33516;1528;35044
RO;11;00189;Pimenta Bueno;33845;1153;34998
RO;11;00205;Porto Velho;442774;17639;460413
RO;11;00254;Presidente Médici;18624;703;19327
RO;11;00262;Rio Crespo;3418;53;3471
RO;11;00288;Rolim de Moura;54095;2311;56406
RO;11;00296;Santa Luzia D'Oeste;7201;218;7419
RO;11;00304;Vilhena;92310;3522;95832
RO;11;00320;São Miguel do Guaporé;21080;555;21635
RO;11;00338;Nova Mamoré;25042;402;25444
RO;11;00346;Alvorada D'Oeste;12794;323;13117
RO;11;00379;Alto Alegre dos Parecis;11175;304;11479
RO;11;00403;Alto Paraíso;15638;682;16320
RO;11;00452;Buritis;26847;1145;27992
RO;11;00502;Novo Horizonte do Oeste;7555;112;7667
RO;11;00601;Cacaulândia;4132;18;4150
RO;11;00700;Campo Novo de Rondônia;8815;29;8844
RO;11;00809;Candeias do Jamari;21350;888;22238
RO;11;00908;Castanheiras;3176;57;3233
RO;11;00924;Chupinguaia;9117;207;9324
RO;11;00940;Cujubim;14405;458;14863
RO;11;01005;Governador Jorge Teixeira;7847;154;8001
RO;11;01104;Itapuã do Oeste;8230;311;8541
RO;11;01203;Ministro Andreazza;6308;158;6466
RO;11;01302;Mirante da Serra;8965;270;9235
RO;11;01401;Monte Negro;11036;512;11548
RO;11;01435;Nova União;5914;286;6200
RO;11;01450;Parecis;3938;187;4125
RO;11;01468;Pimenteiras do Oeste;2077;79;2156
RO;11;01476;Primavera de Rondônia;2986;88;3074
RO;11;01484;São Felipe D'Oeste;5240;18;5258
RO;11;01492;São Francisco do Guaporé;16113;173;16286
RO;11;01500;Seringueiras;11105;66;11171
RO;11;01559;Teixeirópolis;4069;187;4256
RO;11;01609;Theobroma;7913;200;8113
RO;11;01708;Urupá;10355;370;10725
RO;11;01757;Vale do Anari;7614;174;7788
RO;11;01807;Vale do Paraíso;6459;20;6479
AC;12;00013;Acrelândia;13771;250;14021
AC;12;00054;Assis Brasil;7763;337;8100
AC;12;00104;Brasiléia;24903;1097;26000
AC;12;00138;Bujari;12368;549;12917
AC;12;00179;Capixaba;10187;205;10392
AC;12;00203;Cruzeiro do Sul;88305;3583;91888
AC;12;00252;Epitaciolândia;18082;675;18757
AC;12;00302;Feijó;35284;142;35426
AC;12;00328;Jordão;9219;3;9222
AC;12;00336;Mâncio Lima;19039;261;19300
AC;12;00344;Manoel Urbano;11926;70;11996
AC;12;00351;Marechal Thaumaturgo;16890;203;17093
AC;12;00385;Plácido de Castro;16251;309;16560
AC;12;00393;Porto Walter;10492;243;10735
AC;12;00401;Rio Branco;359678;5078;364756
AC;12;00427;Rodrigues Alves;14807;131;14938
AC;12;00435;Santa Rosa do Purus;6611;112;6723
AC;12;00450;Senador Guiomard;21255;198;21453
AC;12;00500;Sena Madureira;41099;250;41349
AC;12;00609;Tarauacá;43176;288;43464
AC;12;00708;Xapuri;17352;891;18243
AC;12;00807;Porto Acre;16295;398;16693
AM;13;00029;Alvarães;15693;173;15866
AM;13;00060;Amaturá;10813;6;10819
AM;13;00086;Anamã;9694;268;9962
AM;13;00102;Anori;17117;77;17194
AM;13;00144;Apuí;19496;1151;20647
AM;13;00201;Atalaia do Norte;15012;302;15314
AM;13;00300;Autazes;40595;987;41582
AM;13;00409;Barcelos;18444;387;18831
AM;13;00508;Barreirinha;30156;909;31065
AM;13;00607;Benjamin Constant;37204;444;37648
AM;13;00631;Beruri;20090;628;20718
AM;13;00680;Boa Vista do Ramos;23775;10;23785
AM;13;00706;Boca do Acre;33888;1559;35447
AM;13;00805;Borba;32359;697;33056
AM;13;00839;Caapiranga;13176;297;13473
AM;13;00904;Canutama;16239;630;16869
AM;13;01001;Carauari;28741;1;28742
AM;13;01100;Careiro;29617;1175;30792
AM;13;01159;Careiro da Várzea;18818;820;19638
AM;13;01209;Coari;67382;3114;70496
AM;13;01308;Codajás;22657;892;23549
AM;13;01407;Eirunepé;33168;2;33170
AM;13;01506;Envira;17186;0;17186
AM;13;01605;Fonte Boa;25378;493;25871
AM;13;01654;Guajará;13773;42;13815
AM;13;01704;Humaitá;54731;2742;57473
AM;13;01803;Ipixuna;24283;28;24311
AM;13;01852;Iranduba;58631;2362;60993
AM;13;01902;Itacoatiara;101272;2326;103598
AM;13;01951;Itamarati;10937;0;10937
AM;13;02009;Itapiranga;10074;88;10162
AM;13;02108;Japurá;8676;182;8858
AM;13;02207;Juruá;10690;52;10742
AM;13;02306;Jutaí;24693;479;25172
AM;13;02405;Lábrea;43792;1656;45448
AM;13;02504;Manacapuru;98469;3414;101883
AM;13;02553;Manaquiri;16712;395;17107
AM;13;02603;Manaus;2010648;52899;2063547
AM;13;02702;Manicoré;51384;2530;53914
AM;13;02801;Maraã;15264;256;15520
AM;13;02900;Maués;59904;1300;61204
AM;13;03007;Nhamundá;19982;153;20135
AM;13;03106;Nova Olinda do Norte;26895;167;27062
AM;13;03205;Novo Airão;15551;210;15761
AM;13;03304;Novo Aripuanã;23171;646;23817
AM;13;03403;Parintins;95036;1336;96372
AM;13;03502;Pauini;19066;307;19373
AM;13;03536;Presidente Figueiredo;30465;203;30668
AM;13;03569;Rio Preto da Eva;24684;252;24936
AM;13;03601;Santa Isabel do Rio Negro;14144;20;14164
AM;13;03700;Santo Antônio do Içá;28051;160;28211
AM;13;03809;São Gabriel da Cachoeira;51158;637;51795
AM;13;03908;São Paulo de Olivença;32733;234;32967
AM;13;03957;São Sebastião do Uatumã;11614;56;11670
AM;13;04005;Silves;11470;89;11559
AM;13;04062;Tabatinga;65508;1256;66764
AM;13;04104;Tapauá;18837;762;19599
AM;13;04203;Tefé;71997;1672;73669
AM;13;04237;Tonantins;19211;36;19247
AM;13;04260;Uarini;14226;205;14431
AM;13;04302;Urucará;18412;214;18626
AM;13;04401;Urucurituba;23747;198;23945
RR;14;00027;Amajari;13646;281;13927
RR;14;00050;Alto Alegre;20946;120;21066
RR;14;00100;Boa Vista;405815;7671;413486
RR;14;00159;Bonfim;13715;182;13897
RR;14;00175;Cantá;18495;187;18682
RR;14;00209;Caracaraí;20691;266;20957
RR;14;00233;Caroebe;10649;7;10656
RR;14;00282;Iracema;9960;63;10023
RR;14;00308;Mucajaí;17997;67;18064
RR;14;00407;Normandia;13600;69;13669
RR;14;00456;Pacaraima;19020;285;19305
RR;14;00472;Rorainópolis;32599;48;32647
RR;14;00506;São João da Baliza;8858;0;8858
RR;14;00605;São Luiz;7315;0;7315
RR;14;00704;Uiramutã;13720;31;13751
PA;15;00107;Abaetetuba;154054;4134;158188
PA;15;00131;Abel Figueiredo;7021;9;7030
PA;15;00206;Acará;57137;248;57385
PA;15;00305;Afuá;37092;673;37765
PA;15;00347;Água Azul do Norte;17375;705;18080
PA;15;00404;Alenquer;68934;443;69377
PA;15;00503;Almeirim;33612;668;34280
PA;15;00602;Altamira;119678;6601;126279
PA;15;00701;Anajás;27904;107;28011
PA;15;00800;Ananindeua;459898;18880;478778
PA;15;00859;Anapu;30835;1015;31850
PA;15;00909;Augusto Corrêa;44573;0;44573
PA;15;00958;Aurora do Pará;23325;307;23632
PA;15;01006;Aveiro;17954;336;18290
PA;15;01105;Bagre;34682;29;34711
PA;15;01204;Baião;51516;125;51641
PA;15;01253;Bannach;3824;207;4031
PA;15;01303;Barcarena;121818;4832;126650
PA;15;01402;Belém;1241614;61775;1303389
PA;15;01451;Belterra;17633;466;18099
PA;15;01501;Benevides;62502;1065;63567
PA;15;01576;Bom Jesus do Tocantins;17564;441;18005
PA;15;01600;Bonito;12420;202;12622
PA;15;01709;Bragança;121941;1141;123082
PA;15;01725;Brasil Novo;24178;540;24718
PA;15;01758;Brejo Grande do Araguaia;6762;21;6783
PA;15;01782;Breu Branco;44763;949;45712
PA;15;01808;Breves;106714;254;106968
PA;15;01907;Bujaru;24008;375;24383
PA;15;01956;Cachoeira do Piriá;18645;985;19630
PA;15;02004;Cachoeira do Arari;23873;108;23981
PA;15;02103;Cametá;131955;2229;134184
PA;15;02152;Canaã dos Carajás;74095;2984;77079
PA;15;02202;Capanema;67792;2602;70394
PA;15;02301;Capitão Poço;55826;506;56332
PA;15;02400;Castanhal;184729;7533;192262
PA;15;02509;Chaves;20732;25;20757
PA;15;02608;Colares;12839;29;12868
PA;15;02707;Conceição do Araguaia;42764;1853;44617
PA;15;02756;Concórdia do Pará;26580;301;26881
PA;15;02764;Cumaru do Norte;12891;1145;14036
PA;15;02772;Curionópolis;19496;454;19950
PA;15;02806;Curralinho;33894;9;33903
PA;15;02855;Curuá;14071;46;14117
PA;15;02905;Curuçá;39170;1172;40342
PA;15;02939;Dom Eliseu;57747;737;58484
PA;15;02954;Eldorado do Carajás;26552;1640;28192
PA;15;03002;Faro;8728;0;8728
PA;15;03044;Floresta do Araguaia;17192;706;17898
PA;15;03077;Garrafão do Norte;24555;148;24703
PA;15;03093;Goianésia do Pará;24867;1413;26280
PA;15;03101;Gurupá;31401;387;31788
PA;15;03200;Igarapé-Açu;35643;154;35797
PA;15;03309;Igarapé-Miri;63671;1160;64831
PA;15;03408;Inhangapi;10094;231;10325
PA;15;03457;Ipixuna do Pará;29917;412;30329
PA;15;03507;Irituia;30523;432;30955
PA;15;03606;Itaituba;118837;4475;123312
PA;15;03705;Itupiranga;47938;1814;49752
PA;15;03754;Jacareacanga;22058;1984;24042
PA;15;03804;Jacundá;35924;1783;37707
PA;15;03903;Juruti;50035;846;50881
PA;15;04000;Limoeiro do Ajuru;29274;295;29569
PA;15;04059;Mãe do Rio;34215;138;34353
PA;15;04109;Magalhães Barata;8103;12;8115
PA;15;04208;Marabá;256493;10043;266536
PA;15;04307;Maracanã;25308;504;25812
PA;15;04406;Marapanim;26167;304;26471
PA;15;04422;Marituba;108717;1798;110515
PA;15;04455;Medicilândia;26893;184;27077
PA;15;04505;Melgaço;27866;10;27876
PA;15;04604;Mocajuba;26951;247;27198
PA;15;04703;Moju;81163;1876;83039
PA;15;04752;Mojuí dos Campos;23187;314;23501
PA;15;04802;Monte Alegre;59523;493;60016
PA;15;04901;Muaná;45248;120;45368
PA;15;04950;Nova Esperança do Piriá;20217;261;20478
PA;15;04976;Nova Ipixuna;13523;432;13955
PA;15;05007;Nova Timboteua;12684;122;12806
PA;15;05031;Novo Progresso;33104;534;33638
PA;15;05064;Novo Repartimento;58733;1999;60732
PA;15;05106;Óbidos;51625;604;52229
PA;15;05205;Oeiras do Pará;33629;215;33844
PA;15;05304;Oriximiná;67100;1194;68294
PA;15;05403;Ourém;17449;406;17855
PA;15;05437;Ourilândia do Norte;31108;1359;32467
PA;15;05486;Pacajá;40122;975;41097
PA;15;05494;Palestina do Pará;6845;40;6885
PA;15;05502;Paragominas;101033;4505;105538
PA;15;05536;Parauapebas;256902;9522;266424
PA;15;05551;Pau D'Arco;6710;221;6931
PA;15;05601;Peixe-Boi;8134;151;8285
PA;15;05635;Piçarra;12704;128;12832
PA;15;05650;Placas;18377;291;18668
PA;15;05700;Ponta de Pedras;24821;163;24984
PA;15;05809;Portel;62159;286;62445
PA;15;05908;Porto de Moz;40238;359;40597
PA;15;06005;Prainha;35467;110;35577
PA;15;06104;Primavera;10601;76;10677
PA;15;06112;Quatipuru;11334;190;11524
PA;15;06138;Redenção;81630;3967;85597
PA;15;06161;Rio Maria;17644;740;18384
PA;15;06187;Rondon do Pará;51380;1763;53143
PA;15;06195;Rurópolis;35084;685;35769
PA;15;06203;Salinópolis;42926;1846;44772
PA;15;06302;Salvaterra;23449;680;24129
PA;15;06351;Santa Bárbara do Pará;20672;417;21089
PA;15;06401;Santa Cruz do Arari;7385;60;7445
PA;15;06500;Santa Izabel do Pará;70380;2639;73019
PA;15;06559;Santa Luzia do Pará;20230;140;20370
PA;15;06583;Santa Maria das Barreiras;16201;347;16548
PA;15;06609;Santa Maria do Pará;24463;161;24624
PA;15;06708;Santana do Araguaia;30847;1566;32413
PA;15;06807;Santarém;317104;14833;331937
PA;15;06906;Santarém Novo;6114;2;6116
PA;15;07003;Santo Antônio do Tauá;27219;242;27461
PA;15;07102;São Caetano de Odivelas;16628;38;16666
PA;15;07151;São Domingos do Araguaia;20625;467;21092
PA;15;07201;São Domingos do Capim;30590;9;30599
PA;15;07300;São Félix do Xingu;63254;2164;65418
PA;15;07409;São Francisco do Pará;14374;520;14894
PA;15;07458;São Geraldo do Araguaia;23482;773;24255
PA;15;07466;São João da Ponta;4243;187;4430
PA;15;07474;São João de Pirabas;20329;360;20689
PA;15;07508;São João do Araguaia;13077;388;13465
PA;15;07607;São Miguel do Guamá;52675;220;52895
PA;15;07706;São Sebastião da Boa Vista;25491;152;25643
PA;15;07755;Sapucaia;5642;205;5847
PA;15;07805;Senador José Porfírio;22138;438;22576
PA;15;07904;Soure;24039;165;24204
PA;15;07953;Tailândia;70014;2479;72493
PA;15;07961;Terra Alta;10357;43;10400
PA;15;07979;Terra Santa;18629;153;18782
PA;15;08001;Tomé-Açu;66770;535;67305
PA;15;08035;Tracuateua;28529;66;28595
PA;15;08050;Trairão;15199;43;15242
PA;15;08084;Tucumã;38453;1097;39550
PA;15;08100;Tucuruí;88796;2510;91306
PA;15;08126;Ulianópolis;37322;650;37972
PA;15;08159;Uruará;42949;609;43558
PA;15;08209;Vigia;50319;513;50832
PA;15;08308;Viseu;58522;170;58692
PA;15;08357;Vitória do Xingu;15399;200;15599
PA;15;08407;Xinguara;50431;2462;52893
AP;16;00055;Serra do Navio;4538;135;4673
AP;16;00105;Amapá;7936;7;7943
AP;16;00154;Pedra Branca do Amapari;12380;467;12847
AP;16;00204;Calçoene;10587;25;10612
AP;16;00212;Cutias;4396;65;4461
AP;16;00238;Ferreira Gomes;6543;123;6666
AP;16;00253;Itaubal;5564;35;5599
AP;16;00279;Laranjal do Jari;34299;815;35114
AP;16;00303;Macapá;430772;12161;442933
AP;16;00402;Mazagão;21218;700;21918
AP;16;00501;Oiapoque;26953;529;27482
AP;16;00535;Porto Grande;17274;574;17848
AP;16;00550;Pracuúba;3803;0;3803
AP;16;00600;Santana;104873;2500;107373
AP;16;00709;Tartarugalzinho;12773;172;12945
AP;16;00808;Vitória do Jari;11245;46;11291
TO;17;00251;Abreulândia;2517;59;2576
TO;17;00301;Aguiarnópolis;4326;171;4497
TO;17;00350;Aliança do Tocantins;4980;167;5147
TO;17;00400;Almas;6352;147;6499
TO;17;00707;Alvorada;8520;282;8802
TO;17;01002;Ananás;10315;10;10325
TO;17;01051;Angico;2803;73;2876
TO;17;01101;Aparecida do Rio Negro;4666;190;4856
TO;17;01309;Aragominas;5094;196;5290
TO;17;01903;Araguacema;5835;92;5927
TO;17;02000;Araguaçu;8012;121;8133
TO;17;02109;Araguaína;165010;6291;171301
TO;17;02158;Araguanã;4308;2;4310
TO;17;02208;Araguatins;30777;1141;31918
TO;17;02307;Arapoema;5413;137;5550
TO;17;02406;Arraias;10285;2;10287
TO;17;02554;Augustinópolis;16824;660;17484
TO;17;02703;Aurora do Tocantins;3339;3;3342
TO;17;02901;Axixá do Tocantins;10249;13;10262
TO;17;03008;Babaçulândia;7508;372;7880
TO;17;03057;Bandeirantes do Tocantins;3348;59;3407
TO;17;03073;Barra do Ouro;4359;117;4476
TO;17;03107;Barrolândia;4714;132;4846
TO;17;03206;Bernardo Sayão;4197;32;4229
TO;17;03305;Bom Jesus do Tocantins;3848;185;4033
TO;17;03602;Brasilândia do Tocantins;1913;61;1974
TO;17;03701;Brejinho de Nazaré;4607;118;4725
TO;17;03800;Buriti do Tocantins;10206;101;10307
TO;17;03826;Cachoeirinha;1954;7;1961
TO;17;03842;Campos Lindos;8568;85;8653
TO;17;03867;Cariri do Tocantins;3919;88;4007
TO;17;03883;Carmolândia;2153;48;2201
TO;17;03891;Carrasco Bonito;3316;2;3318
TO;17;03909;Caseara;4735;112;4847
TO;17;04105;Centenário;2123;8;2131
TO;17;04600;Chapada de Areia;1444;57;1501
TO;17;05102;Chapada da Natividade;3105;12;3117
TO;17;05508;Colinas do Tocantins;33362;871;34233
TO;17;05557;Combinado;4756;0;4756
TO;17;05607;Conceição do Tocantins;3884;3;3887
TO;17;06001;Couto Magalhães;5274;57;5331
TO;17;06100;Cristalândia;6295;76;6371
TO;17;06258;Crixás do Tocantins;1418;52;1470
TO;17;06506;Darcinópolis;5690;137;5827
TO;17;07009;Dianópolis;17610;129;17739
TO;17;07108;Divinópolis do Tocantins;6863;161;7024
TO;17;07207;Dois Irmãos do Tocantins;6139;188;6327
TO;17;07306;Dueré;4136;112;4248
TO;17;07405;Esperantina;7386;144;7530
TO;17;07553;Fátima;3347;120;3467
TO;17;07652;Figueirópolis;4967;244;5211
TO;17;07702;Filadélfia;7371;341;7712
TO;17;08205;Formoso do Araguaia;18840;41;18881
TO;17;08254;Tabocão;3384;71;3455
TO;17;08304;Goianorte;4581;157;4738
TO;17;09005;Goiatins;12185;248;12433
TO;17;09302;Guaraí;23751;1024;24775
TO;17;09500;Gurupi;83144;1982;85126
TO;17;09807;Ipueiras;1583;7;1590
TO;17;10508;Itacajá;6707;112;6819
TO;17;10706;Itaguatins;5105;67;5172
TO;17;10904;Itapiratins;3518;59;3577
TO;17;11100;Itaporã do Tocantins;2284;120;2404
TO;17;11506;Jaú do Tocantins;3194;140;3334
TO;17;11803;Juarina;2229;14;2243
TO;17;11902;Lagoa da Confusão;14662;626;15288
TO;17;11951;Lagoa do Tocantins;3378;138;3516
TO;17;12009;Lajeado;3232;125;3357
TO;17;12157;Lavandeira;1624;2;1626
TO;17;12405;Lizarda;2994;5;2999
TO;17;12454;Luzinópolis;2642;75;2717
TO;17;12504;Marianópolis do Tocantins;4550;65;4615
TO;17;12702;Mateiros;2668;80;2748
TO;17;12801;Maurilândia do Tocantins;3089;6;3095
TO;17;13205;Miracema do Tocantins;17744;822;18566
TO;17;13304;Miranorte;12147;554;12701
TO;17;13601;Monte do Carmo;5494;200;5694
TO;17;13700;Monte Santo do Tocantins;2277;119;2396
TO;17;13809;Palmeiras do Tocantins;4854;18;4872
TO;17;13957;Muricilândia;3265;102;3367
TO;17;14203;Natividade;8665;89;8754
TO;17;14302;Nazaré;4370;151;4521
TO;17;14880;Nova Olinda;10270;97;10367
TO;17;15002;Nova Rosalândia;3227;135;3362
TO;17;15101;Novo Acordo;3953;16;3969
TO;17;15150;Novo Alegre;1846;0;1846
TO;17;15259;Novo Jardim;2195;35;2230
TO;17;15507;Oliveira de Fátima;1143;21;1164
TO;17;15705;Palmeirante;4585;213;4798
TO;17;15754;Palmeirópolis;6813;162;6975
TO;17;16109;Paraíso do Tocantins;50127;2233;52360
TO;17;16208;Paranã;10421;121;10542
TO;17;16307;Pau D'Arco;3977;66;4043
TO;17;16505;Pedro Afonso;13465;590;14055
TO;17;16604;Peixe;9296;21;9317
TO;17;16653;Pequizeiro;4886;35;4921
TO;17;16703;Colméia;8539;402;8941
TO;17;17008;Pindorama do Tocantins;4286;192;4478
TO;17;17206;Piraquê;2239;43;2282
TO;17;17503;Pium;7037;91;7128
TO;17;17800;Ponte Alta do Bom Jesus;4219;1;4220
TO;17;17909;Ponte Alta do Tocantins;7265;321;7586
TO;17;18006;Porto Alegre do Tocantins;2862;4;2866
TO;17;18204;Porto Nacional;62415;2003;64418
TO;17;18303;Praia Norte;8969;75;9044
TO;17;18402;Presidente Kennedy;2849;198;3047
TO;17;18451;Pugmil;2149;44;2193
TO;17;18501;Recursolândia;3263;158;3421
TO;17;18550;Riachinho;3960;0;3960
TO;17;18659;Rio da Conceição;1751;17;1768
TO;17;18709;Rio dos Bois;2714;24;2738
TO;17;18758;Rio Sono;4787;54;4841
TO;17;18808;Sampaio;4182;33;4215
TO;17;18840;Sandolândia;3595;128;3723
TO;17;18865;Santa Fé do Araguaia;6895;321;7216
TO;17;18881;Santa Maria do Tocantins;2559;121;2680
TO;17;18899;Santa Rita do Tocantins;2164;55;2219
TO;17;18907;Santa Rosa do Tocantins;4481;175;4656
TO;17;19004;Santa Tereza do Tocantins;2677;104;2781
TO;17;20002;Santa Terezinha do Tocantins;2340;66;2406
TO;17;20101;São Bento do Tocantins;5490;164;5654
TO;17;20150;São Félix do Tocantins;1783;0;1783
TO;17;20200;São Miguel do Tocantins;12752;489;13241
TO;17;20259;São Salvador do Tocantins;2358;27;2385
TO;17;20309;São Sebastião do Tocantins;4096;4;4100
TO;17;20499;São Valério;4411;11;4422
TO;17;20655;Silvanópolis;4911;197;5108
TO;17;20804;Sítio Novo do Tocantins;10830;0;10830
TO;17;20853;Sucupira;1573;4;1577
TO;17;20903;Taguatinga;13871;140;14011
TO;17;20937;Taipas do Tocantins;2020;1;2021
TO;17;20978;Talismã;2359;97;2456
TO;17;21000;Palmas;293487;9205;302692
TO;17;21109;Tocantínia;7284;175;7459
TO;17;21208;Tocantinópolis;21901;714;22615
TO;17;21257;Tupirama;1831;78;1909
TO;17;21307;Tupiratins;1850;24;1874
TO;17;22081;Wanderlândia;10182;340;10522
TO;17;22107;Xambioá;10509;8;10517
MA;21;00055;Açailândia;101917;4633;106550
MA;21;00105;Afonso Cunha;6136;8;6144
MA;21;00154;Água Doce do Maranhão;11924;218;12142
MA;21;00204;Alcântara;18172;294;18466
MA;21;00303;Aldeias Altas;23244;42;23286
MA;21;00402;Altamira do Maranhão;6412;35;6447
MA;21;00436;Alto Alegre do Maranhão;23425;623;24048
MA;21;00477;Alto Alegre do Pindaré;25416;294;25710
MA;21;00501;Alto Parnaíba;10799;310;11109
MA;21;00550;Amapá do Maranhão;7135;35;7170
MA;21;00600;Amarante do Maranhão;36153;938;37091
MA;21;00709;Anajatuba;24459;863;25322
MA;21;00808;Anapurus;13753;40;13793
MA;21;00832;Apicum-Açu;17484;35;17519
MA;21;00873;Araguanã;11157;25;11182
MA;21;00907;Araioses;38791;261;39052
MA;21;00956;Arame;25166;354;25520
MA;21;01004;Arari;29103;369;29472
MA;21;01103;Axixá;11702;88;11790
MA;21;01202;Bacabal;99661;4050;103711
MA;21;01251;Bacabeira;16203;763;16966
MA;21;01301;Bacuri;16033;257;16290
MA;21;01350;Bacurituba;5183;72;5255
MA;21;01400;Balsas;97170;4446;101616
MA;21;01509;Barão de Grajaú;18143;841;18984
MA;21;01608;Barra do Corda;81585;2947;84532
MA;21;01707;Barreirinhas;63899;1684;65583
MA;21;01731;Belágua;8239;221;8460
MA;21;01772;Bela Vista do Maranhão;11467;283;11750
MA;21;01806;Benedito Leite;5457;12;5469
MA;21;01905;Bequimão;19276;304;19580
MA;21;01939;Bernardo do Mearim;5838;2;5840
MA;21;01970;Boa Vista do Gurupi;7440;134;7574
MA;21;02002;Bom Jardim;32503;642;33145
MA;21;02036;Bom Jesus das Selvas;28104;495;28599
MA;21;02077;Bom Lugar;12010;202;12212
MA;21;02101;Brejo;34027;93;34120
MA;21;02150;Brejo de Areia;9129;89;9218
MA;21;02200;Buriti;29555;130;29685
MA;21;02309;Buriti Bravo;22057;398;22455
MA;21;02325;Buriticupu;54291;1216;55507
MA;21;02358;Buritirana;12912;6;12918
MA;21;02374;Cachoeira Grande;9483;249;9732
MA;21;02408;Cajapió;9932;189;10121
MA;21;02507;Cajari;16081;331;16412
MA;21;02556;Campestre do Maranhão;11923;378;12301
MA;21;02606;Cândido Mendes;19235;697;19932
MA;21;02705;Cantanhede;23380;923;24303
MA;21;02754;Capinzal do Norte;11237;137;11374
MA;21;02804;Carolina;23887;175;24062
MA;21;02903;Carutapera;23881;357;24238
MA;21;03000;Caxias;153286;3684;156970
MA;21;03109;Cedral;10206;2;10208
MA;21;03125;Central do Maranhão;7037;57;7094
MA;21;03158;Centro do Guilherme;12125;217;12342
MA;21;03174;Centro Novo do Maranhão;15731;536;16267
MA;21;03208;Chapadinha;79229;2157;81386
MA;21;03257;Cidelândia;12832;46;12878
MA;21;03307;Codó;109624;4645;114269
MA;21;03406;Coelho Neto;41337;321;41658
MA;21;03505;Colinas;39597;709;40306
MA;21;03554;Conceição do Lago-Açu;14795;120;14915
MA;21;03604;Coroatá;58356;1210;59566
MA;21;03703;Cururupu;30628;930;31558
MA;21;03752;Davinópolis;14116;288;14404
MA;21;03802;Dom Pedro;22439;614;23053
MA;21;03901;Duque Bacelar;10223;0;10223
MA;21;04008;Esperantinópolis;18061;250;18311
MA;21;04057;Estreito;32780;514;33294
MA;21;04073;Feira Nova do Maranhão;8048;0;8048
MA;21;04081;Fernando Falcão;10829;44;10873
MA;21;04099;Formosa da Serra Negra;17534;185;17719
MA;21;04107;Fortaleza dos Nogueiras;12624;16;12640
MA;21;04206;Fortuna;16383;593;16976
MA;21;04305;Godofredo Viana;9841;345;10186
MA;21;04404;Gonçalves Dias;16779;427;17206
MA;21;04503;Governador Archer;10216;12;10228
MA;21;04552;Governador Edison Lobão;17543;868;18411
MA;21;04602;Governador Eugênio Barros;13651;279;13930
MA;21;04628;Governador Luiz Rocha;7055;8;7063
MA;21;04651;Governador Newton Bello;10679;34;10713
MA;21;04677;Governador Nunes Freire;22727;401;23128
MA;21;04701;Graça Aranha;5966;57;6023
MA;21;04800;Grajaú;71798;2074;73872
MA;21;04909;Guimarães;10265;25;10290
MA;21;05005;Humberto de Campos;25282;387;25669
MA;21;05104;Icatu;24552;242;24794
MA;21;05153;Igarapé do Meio;13629;345;13974
MA;21;05203;Igarapé Grande;10015;216;10231
MA;21;05302;Imperatriz;266990;6120;273110
MA;21;05351;Itaipava do Grajaú;13678;150;13828
MA;21;05401;Itapecuru Mirim;57689;2730;60419
MA;21;05427;Itinga do Maranhão;21492;1021;22513
MA;21;05450;Jatobá;7251;220;7471
MA;21;05476;Jenipapo dos Vieiras;17018;58;17076
MA;21;05500;João Lisboa;24635;74;24709
MA;21;05609;Joselândia;14788;136;14924
MA;21;05658;Junco do Maranhão;5128;18;5146
MA;21;05708;Lago da Pedra;42504;1899;44403
MA;21;05807;Lago do Junco;9341;165;9506
MA;21;05906;Lago Verde;14628;141;14769
MA;21;05922;Lagoa do Mato;10567;5;10572
MA;21;05948;Lago dos Rodrigues;8674;84;8758
MA;21;05963;Lagoa Grande do Maranhão;11165;246;11411
MA;21;05989;Lajeado Novo;7019;41;7060
MA;21;06003;Lima Campos;11202;95;11297
MA;21;06102;Loreto;11543;48;11591
MA;21;06201;Luís Domingues;7115;46;7161
MA;21;06300;Magalhães de Almeida;13570;237;13807
MA;21;06326;Maracaçumé;21085;64;21149
MA;21;06359;Marajá do Sena;6865;169;7034
MA;21;06375;Maranhãozinho;13631;130;13761
MA;21;06409;Mata Roma;16868;222;17090
MA;21;06508;Matinha;21394;640;22034
MA;21;06607;Matões;31367;807;32174
MA;21;06631;Matões do Norte;16999;433;17432
MA;21;06672;Milagres do Maranhão;8781;37;8818
MA;21;06706;Mirador;20422;608;21030
MA;21;06755;Miranda do Norte;22877;987;23864
MA;21;06805;Mirinzal;13784;194;13978
MA;21;06904;Monção;26818;933;27751
MA;21;07001;Montes Altos;8995;112;9107
MA;21;07100;Morros;17976;578;18554
MA;21;07209;Nina Rodrigues;13639;421;14060
MA;21;07258;Nova Colinas;5015;6;5021
MA;21;07308;Nova Iorque;4297;23;4320
MA;21;07357;Nova Olinda do Maranhão;14259;55;14314
MA;21;07407;Olho d'Água das Cunhãs;17534;385;17919
MA;21;07456;Olinda Nova do Maranhão;13246;331;13577
MA;21;07506;Paço do Lumiar;139540;6103;145643
MA;21;07605;Palmeirândia;21030;29;21059
MA;21;07704;Paraibano;18114;160;18274
MA;21;07803;Parnarama;30603;647;31250
MA;21;07902;Passagem Franca;16984;236;17220
MA;21;08009;Pastos Bons;18730;72;18802
MA;21;08058;Paulino Neves;17056;0;17056
MA;21;08108;Paulo Ramos;19884;457;20341
MA;21;08207;Pedreiras;36195;855;37050
MA;21;08256;Pedro do Rosário;24051;269;24320
MA;21;08306;Penalva;31342;1169;32511
MA;21;08405;Peri Mirim;11029;77;11106
MA;21;08454;Peritoró;20457;22;20479
MA;21;08504;Pindaré-Mirim;30577;837;31414
MA;21;08603;Pinheiro;81919;2695;84614
MA;21;08702;Pio XII;21242;644;21886
MA;21;08801;Pirapemas;17027;687;17714
MA;21;08900;Poção de Pedras;16952;209;17161
MA;21;09007;Porto Franco;23287;616;23903
MA;21;09056;Porto Rico do Maranhão;5882;72;5954
MA;21;09106;Presidente Dutra;44276;879;45155
MA;21;09205;Presidente Juscelino;11232;124;11356
MA;21;09239;Presidente Médici;4620;76;4696
MA;21;09270;Presidente Sarney;17294;176;17470
MA;21;09304;Presidente Vargas;10182;316;10498
MA;21;09403;Primeira Cruz;13609;5;13614
MA;21;09452;Raposa;29614;1225;30839
MA;21;09502;Riachão;22127;18;22145
MA;21;09551;Ribamar Fiquene;7406;14;7420
MA;21;09601;Rosário;36835;1640;38475
MA;21;09700;Sambaíba;5528;40;5568
MA;21;09759;Santa Filomena do Maranhão;6645;52;6697
MA;21;09809;Santa Helena;41224;337;41561
MA;21;09908;Santa Inês;82586;2428;85014
MA;21;10005;Santa Luzia;56778;857;57635
MA;21;10039;Santa Luzia do Paruá;24025;282;24307
MA;21;10104;Santa Quitéria do Maranhão;23309;648;23957
MA;21;10203;Santa Rita;35338;1697;37035
MA;21;10237;Santana do Maranhão;10170;397;10567
MA;21;10278;Santo Amaro do Maranhão;12785;886;13671
MA;21;10302;Santo Antônio dos Lopes;13838;466;14304
MA;21;10401;São Benedito do Rio Preto;18299;65;18364
MA;21;10500;São Bento;46113;284;46397
MA;21;10609;São Bernardo;26042;901;26943
MA;21;10658;São Domingos do Azeitão;7694;298;7992
MA;21;10708;São Domingos do Maranhão;33365;669;34034
MA;21;10807;São Félix de Balsas;4402;0;4402
MA;21;10856;São Francisco do Brejão;8925;126;9051
MA;21;10906;São Francisco do Maranhão;11940;124;12064
MA;21;11003;São João Batista;18284;260;18544
MA;21;11029;São João do Carú;12118;133;12251
MA;21;11052;São João do Paraíso;9850;54;9904
MA;21;11078;São João do Soter;16782;107;16889
MA;21;11102;São João dos Patos;24214;806;25020
MA;21;11201;São José de Ribamar;234126;10453;244579
MA;21;11250;São José dos Basílios;6931;26;6957
MA;21;11300;São Luís;992067;45708;1037775
MA;21;11409;São Luís Gonzaga do Maranhão;17386;432;17818
MA;21;11508;São Mateus do Maranhão;37880;949;38829
MA;21;11532;São Pedro da Água Branca;13232;212;13444
MA;21;11573;São Pedro dos Crentes;5783;0;5783
MA;21;11607;São Raimundo das Mangabeiras;18482;190;18672
MA;21;11631;São Raimundo do Doca Bezerra;5599;51;5650
MA;21;11672;São Roberto;4439;105;4544
MA;21;11706;São Vicente Ferrer;18875;623;19498
MA;21;11722;Satubinha;8621;163;8784
MA;21;11748;Senador Alexandre Costa;10117;90;10207
MA;21;11763;Senador La Rocque;14640;60;14700
MA;21;11789;Serrano do Maranhão;10041;161;10202
MA;21;11805;Sítio Novo;16437;637;17074
MA;21;11904;Sucupira do Norte;9950;288;10238
MA;21;11953;Sucupira do Riachão;4889;96;4985
MA;21;12001;Tasso Fragoso;8634;228;8862
MA;21;12100;Timbiras;26362;122;26484
MA;21;12209;Timon;167258;7207;174465
MA;21;12233;Trizidela do Vale;21732;752;22484
MA;21;12274;Tufilândia;5427;80;5507
MA;21;12308;Tuntum;35143;1108;36251
MA;21;12407;Turiaçu;37452;39;37491
MA;21;12456;Turilândia;31329;309;31638
MA;21;12506;Tutóia;52168;1188;53356
MA;21;12605;Urbano Santos;32500;312;32812
MA;21;12704;Vargem Grande;41404;1857;43261
MA;21;12803;Viana;50152;1290;51442
MA;21;12852;Vila Nova dos Martírios;9961;401;10362
MA;21;12902;Vitória do Mearim;29859;946;30805
MA;21;13009;Vitorino Freire;29491;1354;30845
MA;21;14007;Zé Doca;40530;271;40801
PI;22;00053;Acauã;6420;0;6420
PI;22;00103;Agricolândia;4825;115;4940
PI;22;00202;Água Branca;17215;358;17573
PI;22;00251;Alagoinha do Piauí;6793;26;6819
PI;22;00277;Alegrete do Piauí;4564;70;4634
PI;22;00301;Alto Longá;13433;46;13479
PI;22;00400;Altos;46579;837;47416
PI;22;00459;Alvorada do Gurguéia;5301;21;5322
PI;22;00509;Amarante;17032;203;17235
PI;22;00608;Angical do Piauí;6827;0;6827
PI;22;00707;Anísio de Abreu;9383;24;9407
PI;22;00806;Antônio Almeida;3143;9;3152
PI;22;00905;Aroazes;5369;0;5369
PI;22;00954;Aroeiras do Itaim;2685;5;2690
PI;22;01002;Arraial;4518;2;4520
PI;22;01051;Assunção do Piauí;7282;170;7452
PI;22;01101;Avelino Lopes;10676;190;10866
PI;22;01150;Baixa Grande do Ribeiro;13264;8;13272
PI;22;01176;Barra D'Alcântara;3992;3;3995
PI;22;01200;Barras;47721;217;47938
PI;22;01309;Barreiras do Piauí;3242;22;3264
PI;22;01408;Barro Duro;6601;39;6640
PI;22;01507;Batalha;26164;136;26300
PI;22;01556;Bela Vista do Piauí;4071;20;4091
PI;22;01572;Belém do Piauí;3422;1;3423
PI;22;01606;Beneditinos;9851;22;9873
PI;22;01705;Bertolínia;5479;83;5562
PI;22;01739;Betânia do Piauí;6213;7;6220
PI;22;01770;Boa Hora;6764;138;6902
PI;22;01804;Bocaina;4003;75;4078
PI;22;01903;Bom Jesus;28408;391;28799
PI;22;01919;Bom Princípio do Piauí;5626;10;5636
PI;22;01929;Bonfim do Piauí;5908;5;5913
PI;22;01945;Boqueirão do Piauí;6523;22;6545
PI;22;01960;Brasileira;8403;33;8436
PI;22;01988;Brejo do Piauí;3887;17;3904
PI;22;02000;Buriti dos Lopes;19538;116;19654
PI;22;02026;Buriti dos Montes;7421;13;7434
PI;22;02059;Cabeceiras do Piauí;10142;70;10212
PI;22;02075;Cajazeiras do Piauí;3108;0;3108
PI;22;02083;Cajueiro da Praia;7934;23;7957
PI;22;02091;Caldeirão Grande do Piauí;5503;0;5503
PI;22;02109;Campinas do Piauí;4908;29;4937
PI;22;02117;Campo Alegre do Fidalgo;4613;3;4616
PI;22;02133;Campo Grande do Piauí;5985;35;6020
PI;22;02174;Campo Largo do Piauí;7405;14;7419
PI;22;02208;Campo Maior;45010;783;45793
PI;22;02251;Canavieira;3382;32;3414
PI;22;02307;Canto do Buriti;19182;183;19365
PI;22;02406;Capitão de Campos;10975;125;11100
PI;22;02455;Capitão Gervásio Oliveira;3953;21;3974
PI;22;02505;Caracol;10301;17;10318
PI;22;02539;Caraúbas do Piauí;5628;2;5630
PI;22;02554;Caridade do Piauí;5013;20;5033
PI;22;02604;Castelo do Piauí;19131;157;19288
PI;22;02653;Caxingó;5488;8;5496
PI;22;02703;Cocal;28090;122;28212
PI;22;02711;Cocal de Telha;4831;80;4911
PI;22;02729;Cocal dos Alves;6382;4;6386
PI;22;02737;Coivaras;4015;28;4043
PI;22;02752;Colônia do Gurguéia;6124;26;6150
PI;22;02778;Colônia do Piauí;6952;39;6991
PI;22;02802;Conceição do Canindé;4910;22;4932
PI;22;02851;Coronel José Dias;4219;31;4250
PI;22;02901;Corrente;26710;575;27285
PI;22;03008;Cristalândia do Piauí;7215;68;7283
PI;22;03107;Cristino Castro;10483;20;10503
PI;22;03206;Curimatá;11206;64;11270
PI;22;03230;Currais;4814;30;4844
PI;22;03255;Curralinhos;4403;10;4413
PI;22;03271;Curral Novo do Piauí;5073;0;5073
PI;22;03305;Demerval Lobão;15685;168;15853
PI;22;03354;Dirceu Arcoverde;7017;37;7054
PI;22;03404;Dom Expedito Lopes;6287;33;6320
PI;22;03420;Domingos Mourão;4069;6;4075
PI;22;03453;Dom Inocêncio;9159;0;9159
PI;22;03503;Elesbão Veloso;13452;155;13607
PI;22;03602;Eliseu Martins;4356;21;4377
PI;22;03701;Esperantina;40798;172;40970
PI;22;03750;Fartura do Piauí;5284;0;5284
PI;22;03800;Flores do Piauí;4412;2;4414
PI;22;03859;Floresta do Piauí;2326;7;2333
PI;22;03909;Floriano;59814;2222;62036
PI;22;04006;Francinópolis;4505;0;4505
PI;22;04105;Francisco Ayres;4387;25;4412
PI;22;04154;Francisco Macedo;2924;5;2929
PI;22;04204;Francisco Santos;8158;79;8237
PI;22;04303;Fronteiras;10022;237;10259
PI;22;04352;Geminiano;5419;26;5445
PI;22;04402;Gilbués;10786;106;10892
PI;22;04501;Guadalupe;10030;240;10270
PI;22;04550;Guaribas;4245;31;4276
PI;22;04600;Hugo Napoleão;3449;69;3518
PI;22;04659;Ilha Grande;9164;110;9274
PI;22;04709;Inhuma;14898;60;14958
PI;22;04808;Ipiranga do Piauí;9358;62;9420
PI;22;04907;Isaías Coelho;7756;18;7774
PI;22;05003;Itainópolis;10550;240;10790
PI;22;05102;Itaueira;10239;84;10323
PI;22;05151;Jacobina do Piauí;5604;9;5613
PI;22;05201;Jaicós;17097;430;17527
PI;22;05250;Jardim do Mulato;4177;3;4180
PI;22;05276;Jatobá do Piauí;4488;6;4494
PI;22;05300;Jerumenha;4398;99;4497
PI;22;05359;João Costa;2967;3;2970
PI;22;05409;Joaquim Pires;13864;22;13886
PI;22;05458;Joca Marques;5378;16;5394
PI;22;05508;José de Freitas;42522;37;42559
PI;22;05516;Juazeiro do Piauí;5212;2;5214
PI;22;05524;Júlio Borges;5388;0;5388
PI;22;05532;Jurema;4425;0;4425
PI;22;05540;Lagoinha do Piauí;2909;30;2939
PI;22;05557;Lagoa Alegre;8249;7;8256
PI;22;05565;Lagoa do Barro do Piauí;4947;48;4995
PI;22;05573;Lagoa de São Francisco;6322;9;6331
PI;22;05581;Lagoa do Piauí;4786;24;4810
PI;22;05599;Lagoa do Sítio;4497;23;4520
PI;22;05607;Landri Sales;4977;236;5213
PI;22;05706;Luís Correia;30111;530;30641
PI;22;05805;Luzilândia;25281;94;25375
PI;22;05854;Madeiro;8012;20;8032
PI;22;05904;Manoel Emídio;5205;4;5209
PI;22;05953;Marcolândia;8511;22;8533
PI;22;06001;Marcos Parente;4698;26;4724
PI;22;06050;Massapê do Piauí;5165;53;5218
PI;22;06100;Matias Olímpio;10587;54;10641
PI;22;06209;Miguel Alves;32059;91;32150
PI;22;06308;Miguel Leão;1314;4;1318
PI;22;06357;Milton Brandão;6520;22;6542
PI;22;06407;Monsenhor Gil;10225;30;10255
PI;22;06506;Monsenhor Hipólito;7548;29;7577
PI;22;06605;Monte Alegre do Piauí;10619;41;10660
PI;22;06654;Morro Cabeça no Tempo;4370;7;4377
PI;22;06670;Morro do Chapéu do Piauí;6415;10;6425
PI;22;06696;Murici dos Portelas;8985;19;9004
PI;22;06704;Nazaré do Piauí;6613;52;6665
PI;22;06720;Nazária;10222;40;10262
PI;22;06753;Nossa Senhora de Nazaré;5164;64;5228
PI;22;06803;Nossa Senhora dos Remédios;8493;32;8525
PI;22;06902;Novo Oriente do Piauí;6032;65;6097
PI;22;06951;Novo Santo Antônio;2819;8;2827
PI;22;07009;Oeiras;37666;495;38161
PI;22;07108;Olho D'Água do Piauí;2600;37;2637
PI;22;07207;Padre Marcos;6377;5;6382
PI;22;07306;Paes Landim;4071;17;4088
PI;22;07355;Pajeú do Piauí;2998;2;3000
PI;22;07405;Palmeira do Piauí;4939;13;4952
PI;22;07504;Palmeirais;13188;75;13263
PI;22;07553;Paquetá;3807;6;3813
PI;22;07603;Parnaguá;10046;57;10103
PI;22;07702;Parnaíba;156464;5695;162159
PI;22;07751;Passagem Franca do Piauí;4102;33;4135
PI;22;07777;Patos do Piauí;5425;0;5425
PI;22;07793;Pau D'Arco do Piauí;3876;4;3880
PI;22;07801;Paulistana;20925;130;21055
PI;22;07850;Pavussu;3621;7;3628
PI;22;07900;Pedro II;37523;371;37894
PI;22;07934;Pedro Laurentino;2458;0;2458
PI;22;07959;Nova Santa Rita;4071;5;4076
PI;22;08007;Picos;80760;2330;83090
PI;22;08106;Pimenteiras;11130;211;11341
PI;22;08205;Pio IX;17516;97;17613
PI;22;08304;Piracuruca;28075;378;28453
PI;22;08403;Piripiri;64493;957;65450
PI;22;08502;Porto;11888;164;12052
PI;22;08551;Porto Alegre do Piauí;2360;4;2364
PI;22;08601;Prata do Piauí;3029;13;3042
PI;22;08650;Queimada Nova;8728;10;8738
PI;22;08700;Redenção do Gurguéia;8383;11;8394
PI;22;08809;Regeneração;17081;52;17133
PI;22;08858;Riacho Frio;4139;26;4165
PI;22;08874;Ribeira do Piauí;4032;23;4055
PI;22;08908;Ribeiro Gonçalves;6148;16;6164
PI;22;09005;Rio Grande do Piauí;5785;16;5801
PI;22;09104;Santa Cruz do Piauí;5804;27;5831
PI;22;09153;Santa Cruz dos Milagres;3435;0;3435
PI;22;09203;Santa Filomena;6076;11;6087
PI;22;09302;Santa Luz;5281;55;5336
PI;22;09351;Santana do Piauí;4124;1;4125
PI;22;09377;Santa Rosa do Piauí;4644;6;4650
PI;22;09401;Santo Antônio de Lisboa;5806;33;5839
PI;22;09450;Santo Antônio dos Milagres;2133;5;2138
PI;22;09500;Santo Inácio do Piauí;3642;4;3646
PI;22;09559;São Braz do Piauí;4353;5;4358
PI;22;09609;São Félix do Piauí;2842;0;2842
PI;22;09658;São Francisco de Assis do Piauí;5553;24;5577
PI;22;09708;São Francisco do Piauí;5392;0;5392
PI;22;09757;São Gonçalo do Gurguéia;2928;19;2947
PI;22;09807;São Gonçalo do Piauí;4792;45;4837
PI;22;09856;São João da Canabrava;4184;58;4242
PI;22;09872;São João da Fronteira;5513;9;5522
PI;22;09906;São João da Serra;6095;19;6114
PI;22;09955;São João da Varjota;4372;11;4383
PI;22;09971;São João do Arraial;8141;45;8186
PI;22;10003;São João do Piauí;21200;221;21421
PI;22;10052;São José do Divino;4775;66;4841
PI;22;10102;São José do Peixe;3296;1;3297
PI;22;10201;São José do Piauí;6586;11;6597
PI;22;10300;São Julião;5981;44;6025
PI;22;10359;São Lourenço do Piauí;4402;8;4410
PI;22;10375;São Luis do Piauí;2301;8;2309
PI;22;10383;São Miguel da Baixa Grande;2257;12;2269
PI;22;10391;São Miguel do Fidalgo;2829;0;2829
PI;22;10409;São Miguel do Tapuio;17484;70;17554
PI;22;10508;São Pedro do Piauí;13595;160;13755
PI;22;10607;São Raimundo Nonato;38185;749;38934
PI;22;10623;Sebastião Barros;3164;38;3202
PI;22;10631;Sebastião Leal;4426;20;4446
PI;22;10656;Sigefredo Pacheco;9418;42;9460
PI;22;10706;Simões;14288;62;14350
PI;22;10805;Simplício Mendes;13745;136;13881
PI;22;10904;Socorro do Piauí;4115;26;4141
PI;22;10938;Sussuapara;6087;133;6220
PI;22;10953;Tamboril do Piauí;2946;3;2949
PI;22;10979;Tanque do Piauí;2303;13;2316
PI;22;11001;Teresina;831533;34767;866300
PI;22;11100;União;46083;36;46119
PI;22;11209;Uruçuí;24715;488;25203
PI;22;11308;Valença do Piauí;21951;330;22281
PI;22;11357;Várzea Branca;5050;5;5055
PI;22;11407;Várzea Grande;4410;7;4417
PI;22;11506;Vera Mendes;3091;94;3185
PI;22;11605;Vila Nova do Piauí;2874;61;2935
PI;22;11704;Wall Ferraz;4033;26;4059
CE;23;00101;Abaiara;9961;77;10038
CE;23;00150;Acarape;13956;71;14027
CE;23;00200;Acaraú;64542;264;64806
CE;23;00309;Acopiara;44628;334;44962
CE;23;00408;Aiuaba;14076;0;14076
CE;23;00507;Alcântaras;11301;68;11369
CE;23;00606;Altaneira;6724;58;6782
CE;23;00705;Alto Santo;14130;25;14155
CE;23;00754;Amontada;41436;720;42156
CE;23;00804;Antonina do Norte;7232;13;7245
CE;23;00903;Apuiarés;12574;319;12893
CE;23;01000;Aquiraz;73124;7119;80243
CE;23;01109;Aracati;72621;2491;75112
CE;23;01208;Aracoiaba;25461;92;25553
CE;23;01257;Ararendá;11096;0;11096
CE;23;01307;Araripe;19526;257;19783
CE;23;01406;Aratuba;11151;73;11224
CE;23;01505;Arneiroz;7429;0;7429
CE;23;01604;Assaré;21546;151;21697
CE;23;01703;Aurora;23605;109;23714
CE;23;01802;Baixio;5697;7;5704
CE;23;01851;Banabuiú;17195;0;17195
CE;23;01901;Barbalha;73831;1202;75033
CE;23;01950;Barreira;22174;217;22391
CE;23;02008;Barro;19251;130;19381
CE;23;02057;Barroquinha;14567;0;14567
CE;23;02107;Baturité;35069;149;35218
CE;23;02206;Beberibe;52414;700;53114
CE;23;02305;Bela Cruz;32494;281;32775
CE;23;02404;Boa Viagem;50069;342;50411
CE;23;02503;Brejo Santo;50992;98;51090
CE;23;02602;Camocim;61612;714;62326
CE;23;02701;Campos Sales;25098;37;25135
CE;23;02800;Canindé;73428;746;74174
CE;23;02909;Capistrano;17194;60;17254
CE;23;03006;Caridade;16333;44;16377
CE;23;03105;Cariré;17594;38;17632
CE;23;03204;Caririaçu;26296;24;26320
CE;23;03303;Cariús;16853;162;17015
CE;23;03402;Carnaubal;17193;17;17210
CE;23;03501;Cascavel;71710;916;72626
CE;23;03600;Catarina;10243;0;10243
CE;23;03659;Catunda;10444;0;10444
CE;23;03709;Caucaia;345393;10286;355679
CE;23;03808;Cedro;22165;179;22344
CE;23;03907;Chaval;12459;3;12462
CE;23;03931;Choró;12106;7;12113
CE;23;03956;Chorozinho;20147;16;20163
CE;23;04004;Coreaú;20933;19;20952
CE;23;04103;Crateús;76256;134;76390
CE;23;04202;Crato;125650;5400;131050
CE;23;04236;Croatá;17446;35;17481
CE;23;04251;Cruz;28975;653;29628
CE;23;04269;Deputado Irapuan Pinheiro;8930;2;8932
CE;23;04277;Ereré;6469;5;6474
CE;23;04285;Eusébio;70510;3660;74170
CE;23;04301;Farias Brito;17996;221;18217
CE;23;04350;Forquilha;24068;105;24173
CE;23;04400;Fortaleza;2268747;159931;2428678
CE;23;04459;Fortim;17150;144;17294
CE;23;04509;Frecheirinha;15603;12;15615
CE;23;04608;General Sampaio;6731;3;6734
CE;23;04657;Graça;13775;26;13801
CE;23;04707;Granja;52999;345;53344
CE;23;04806;Granjeiro;4840;1;4841
CE;23;04905;Groaíras;10731;179;10910
CE;23;04954;Guaiúba;23929;288;24217
CE;23;05001;Guaraciaba do Norte;41954;99;42053
CE;23;05100;Guaramiranga;5615;39;5654
CE;23;05209;Hidrolândia;17840;15;17855
CE;23;05233;Horizonte;72514;2240;74754
CE;23;05266;Ibaretama;11956;0;11956
CE;23;05308;Ibiapina;23948;17;23965
CE;23;05332;Ibicuitinga;11572;39;11611
CE;23;05357;Icapuí;21242;191;21433
CE;23;05407;Icó;62102;520;62622
CE;23;05506;Iguatu;95060;3004;98064
CE;23;05605;Independência;24024;0;24024
CE;23;05654;Ipaporanga;11565;10;11575
CE;23;05704;Ipaumirim;12026;57;12083
CE;23;05803;Ipu;41072;9;41081
CE;23;05902;Ipueiras;36772;26;36798
CE;23;06009;Iracema;14001;0;14001
CE;23;06108;Irauçuba;23793;122;23915
CE;23;06207;Itaiçaba;7536;0;7536
CE;23;06256;Itaitinga;60910;3738;64648
CE;23;06306;Itapajé;45848;578;46426
CE;23;06405;Itapipoca;129502;1621;131123
CE;23;06504;Itapiúna;17683;158;17841
CE;23;06553;Itarema;42489;237;42726
CE;23;06603;Itatira;20337;87;20424
CE;23;06702;Jaguaretama;17181;51;17232
CE;23;06801;Jaguaribara;10321;35;10356
CE;23;06900;Jaguaribe;33675;51;33726
CE;23;07007;Jaguaruana;30609;1092;31701
CE;23;07106;Jardim;27190;221;27411
CE;23;07205;Jati;7859;2;7861
CE;23;07254;Jijoca de Jericoacoara;24622;933;25555
CE;23;07304;Juazeiro do Norte;283603;2517;286120
CE;23;07403;Jucás;23795;127;23922
CE;23;07502;Lavras da Mangabeira;30778;24;30802
CE;23;07601;Limoeiro do Norte;59462;98;59560
CE;23;07635;Madalena;16795;101;16896
CE;23;07650;Maracanaú;214912;19480;234392
CE;23;07700;Maranguape;104042;1051;105093
CE;23;07809;Marco;25267;532;25799
CE;23;07908;Martinópole;10834;12;10846
CE;23;08005;Massapê;37539;158;37697
CE;23;08104;Mauriti;45508;53;45561
CE;23;08203;Meruoca;15116;46;15162
CE;23;08302;Milagres;25847;53;25900
CE;23;08351;Milhã;13982;17;13999
CE;23;08377;Miraíma;14020;176;14196
CE;23;08401;Missão Velha;36156;666;36822
CE;23;08500;Mombaça;37730;5;37735
CE;23;08609;Monsenhor Tabosa;17096;53;17149
CE;23;08708;Morada Nova;60767;454;61221
CE;23;08807;Moraújo;8233;23;8256
CE;23;08906;Morrinhos;21979;774;22753
CE;23;09003;Mucambo;13636;30;13666
CE;23;09102;Mulungu;10562;7;10569
CE;23;09201;Nova Olinda;15264;135;15399
CE;23;09300;Nova Russas;30690;9;30699
CE;23;09409;Novo Oriente;27542;3;27545
CE;23;09458;Ocara;24471;22;24493
CE;23;09508;Orós;19654;21;19675
CE;23;09607;Pacajus;68017;2517;70534
CE;23;09706;Pacatuba;78320;2918;81238
CE;23;09805;Pacoti;11168;18;11186
CE;23;09904;Pacujá;6034;141;6175
CE;23;10001;Palhano;9339;7;9346
CE;23;10100;Palmácia;10205;37;10242
CE;23;10209;Paracuru;37946;745;38691
CE;23;10258;Paraipaba;31826;390;32216
CE;23;10308;Parambu;31443;2;31445
CE;23;10407;Paramoti;10317;67;10384
CE;23;10506;Pedra Branca;40183;4;40187
CE;23;10605;Penaforte;8866;106;8972
CE;23;10704;Pentecoste;37717;96;37813
CE;23;10803;Pereiro;15267;7;15274
CE;23;10852;Pindoretama;22360;985;23345
CE;23;10902;Piquet Carneiro;16596;20;16616
CE;23;10951;Pires Ferreira;10606;0;10606
CE;23;11009;Poranga;12065;0;12065
CE;23;11108;Porteiras;17041;9;17050
CE;23;11207;Potengi;8782;51;8833
CE;23;11231;Potiretama;5971;3;5974
CE;23;11264;Quiterianópolis;20213;0;20213
CE;23;11306;Quixadá;83625;540;84165
CE;23;11355;Quixelô;15656;254;15910
CE;23;11405;Quixeramobim;81733;389;82122
CE;23;11504;Quixeré;20695;179;20874
CE;23;11603;Redenção;27090;124;27214
CE;23;11702;Reriutaba;18606;0;18606
CE;23;11801;Russas;72631;297;72928
CE;23;11900;Saboeiro;13805;49;13854
CE;23;11959;Salitre;16610;23;16633
CE;23;12007;Santana do Acaraú;30626;2;30628
CE;23;12106;Santana do Cariri;16700;254;16954
CE;23;12205;Santa Quitéria;39976;207;40183
CE;23;12304;São Benedito;47620;20;47640
CE;23;12403;São Gonçalo do Amarante;52648;1373;54021
CE;23;12502;São João do Jaguaribe;5850;5;5855
CE;23;12601;São Luís do Curu;10621;201;10822
CE;23;12700;Senador Pompeu;24263;3;24266
CE;23;12809;Senador Sá;7262;0;7262
CE;23;12908;Sobral;197347;5676;203023
CE;23;13005;Solonópole;18173;6;18179
CE;23;13104;Tabuleiro do Norte;30644;8;30652
CE;23;13203;Tamboril;24813;2;24815
CE;23;13252;Tarrafas;7524;5;7529
CE;23;13302;Tauá;61223;0;61223
CE;23;13351;Tejuçuoca;17154;0;17154
CE;23;13401;Tianguá;80657;849;81506
CE;23;13500;Trairi;57074;1341;58415
CE;23;13559;Tururu;15246;166;15412
CE;23;13609;Ubajara;32561;206;32767
CE;23;13708;Umari;6871;0;6871
CE;23;13757;Umirim;17386;84;17470
CE;23;13807;Uruburetama;20066;123;20189
CE;23;13906;Uruoca;13728;18;13746
CE;23;13955;Varjota;18097;8;18105
CE;23;14003;Várzea Alegre;38763;221;38984
CE;23;14102;Viçosa do Ceará;59546;166;59712
RN;24;00109;Acari;10500;97;10597
RN;24;00208;Açu;55581;921;56502
RN;24;00307;Afonso Bezerra;10820;19;10839
RN;24;00406;Água Nova;2944;2;2946
RN;24;00505;Alexandria;13584;56;13640
RN;24;00604;Almino Afonso;4687;0;4687
RN;24;00703;Alto do Rodrigues;12243;241;12484
RN;24;00802;Angicos;11543;89;11632
RN;24;00901;Antônio Martins;6577;0;6577
RN;24;01008;Apodi;35256;838;36094
RN;24;01107;Areia Branca;23442;651;24093
RN;24;01206;Arês;13053;198;13251
RN;24;01305;Campo Grande;9706;37;9743
RN;24;01404;Baía Formosa;8824;0;8824
RN;24;01453;Baraúna;26382;512;26894
RN;24;01503;Barcelona;3913;73;3986
RN;24;01602;Bento Fernandes;4807;0;4807
RN;24;01651;Bodó;2305;1;2306
RN;24;01701;Bom Jesus;9610;342;9952
RN;24;01800;Brejinho;12159;43;12202
RN;24;01859;Caiçara do Norte;6289;4;6293
RN;24;01909;Caiçara do Rio do Vento;3248;20;3268
RN;24;02006;Caicó;59624;1522;61146
RN;24;02105;Campo Redondo;10167;48;10215
RN;24;02204;Canguaretama;29641;27;29668
RN;24;02303;Caraúbas;19210;367;19577
RN;24;02402;Carnaúba dos Dantas;7987;3;7990
RN;24;02501;Carnaubais;9641;73;9714
RN;24;02600;Ceará-Mirim;77203;1912;79115
RN;24;02709;Cerro Corá;10927;73;11000
RN;24;02808;Coronel Ezequiel;5111;6;5117
RN;24;02907;Coronel João Pessoa;4237;0;4237
RN;24;03004;Cruzeta;7991;14;8005
RN;24;03103;Currais Novos;40969;349;41318
RN;24;03202;Doutor Severiano;7025;19;7044
RN;24;03251;Parnamirim;242534;10182;252716
RN;24;03301;Encanto;5987;29;6016
RN;24;03400;Equador;5349;11;5360
RN;24;03509;Espírito Santo;10583;28;10611
RN;24;03608;Extremoz;59603;1968;61571
RN;24;03707;Felipe Guerra;5917;23;5940
RN;24;03756;Fernando Pedroza;2923;15;2938
RN;24;03806;Florânia;10192;4;10196
RN;24;03905;Francisco Dantas;2700;0;2700
RN;24;04002;Frutuoso Gomes;4122;0;4122
RN;24;04101;Galinhos;2094;10;2104
RN;24;04200;Goianinha;25870;871;26741
RN;24;04309;Governador Dix-Sept Rosado;11794;144;11938
RN;24;04408;Grossos;9836;88;9924
RN;24;04507;Guamaré;14951;344;15295
RN;24;04606;Ielmo Marinho;11484;131;11615
RN;24;04705;Ipanguaçu;13989;142;14131
RN;24;04804;Ipueira;2035;0;2035
RN;24;04853;Itajá;7063;229;7292
RN;24;04903;Itaú;5298;22;5320
RN;24;05009;Jaçanã;7825;9;7834
RN;24;05108;Jandaíra;6498;64;6562
RN;24;05207;Janduís;4678;68;4746
RN;24;05306;Januário Cicco;9023;28;9051
RN;24;05405;Japi;5034;83;5117
RN;24;05504;Jardim de Angicos;2406;31;2437
RN;24;05603;Jardim de Piranhas;13897;80;13977
RN;24;05702;Jardim do Seridó;11577;78;11655
RN;24;05801;João Câmara;32751;539;33290
RN;24;05900;João Dias;2076;0;2076
RN;24;06007;José da Penha;5803;0;5803
RN;24;06106;Jucurutu;17512;281;17793
RN;24;06155;Jundiá;3736;11;3747
RN;24;06205;Lagoa d'Anta;6610;44;6654
RN;24;06304;Lagoa de Pedras;7337;1;7338
RN;24;06403;Lagoa de Velhos;2517;50;2567
RN;24;06502;Lagoa Nova;15439;134;15573
RN;24;06601;Lagoa Salgada;8266;53;8319
RN;24;06700;Lajes;9841;25;9866
RN;24;06809;Lajes Pintadas;4758;29;4787
RN;24;06908;Lucrécia;3490;0;3490
RN;24;07005;Luís Gomes;8995;75;9070
RN;24;07104;Macaíba;78679;3533;82212
RN;24;07203;Macau;27006;363;27369
RN;24;07252;Major Sales;3924;0;3924
RN;24;07302;Marcelino Vieira;7896;0;7896
RN;24;07401;Martins;8125;54;8179
RN;24;07500;Maxaranguape;10202;53;10255
RN;24;07609;Messias Targino;4201;73;4274
RN;24;07708;Montanhas;11294;150;11444
RN;24;07807;Monte Alegre;22306;725;23031
RN;24;07906;Monte das Gameleiras;2266;10;2276
RN;24;08003;Mossoró;257145;7432;264577
RN;24;08102;Natal;725944;25356;751300
RN;24;08201;Nísia Floresta;30631;1311;31942
RN;24;08300;Nova Cruz;33768;501;34269
RN;24;08409;Olho d'Água do Borges;3880;27;3907
RN;24;08508;Ouro Branco;4891;22;4913
RN;24;08607;Paraná;3934;0;3934
RN;24;08706;Paraú;3574;13;3587
RN;24;08805;Parazinho;4749;52;4801
RN;24;08904;Parelhas;21446;53;21499
RN;24;08953;Rio do Fogo;9996;355;10351
RN;24;09100;Passa e Fica;10715;181;10896
RN;24;09209;Passagem;3084;31;3115
RN;24;09308;Patu;10711;298;11009
RN;24;09332;Santa Maria;4757;90;4847
RN;24;09407;Pau dos Ferros;29959;520;30479
RN;24;09506;Pedra Grande;3614;4;3618
RN;24;09605;Pedra Preta;2430;11;2441
RN;24;09704;Pedro Avelino;6190;52;6242
RN;24;09803;Pedro Velho;13643;181;13824
RN;24;09902;Pendências;12192;86;12278
RN;24;10009;Pilões;2965;0;2965
RN;24;10108;Poço Branco;12290;100;12390
RN;24;10207;Portalegre;7601;0;7601
RN;24;10256;Porto do Mangue;5167;61;5228
RN;24;10306;Serra Caiada;9865;260;10125
RN;24;10405;Pureza;9335;27;9362
RN;24;10504;Rafael Fernandes;5416;16;5432
RN;24;10603;Rafael Godeiro;2934;0;2934
RN;24;10702;Riacho da Cruz;2696;5;2701
RN;24;10801;Riacho de Santana;4124;3;4127
RN;24;10900;Riachuelo;7379;10;7389
RN;24;11007;Rodolfo Fernandes;4190;52;4242
RN;24;11056;Tibau;5355;27;5382
RN;24;11106;Ruy Barbosa;3196;10;3206
RN;24;11205;Santa Cruz;36492;821;37313
RN;24;11403;Santana do Matos;12449;7;12456
RN;24;11429;Santana do Seridó;2694;2;2696
RN;24;11502;Santo Antônio;22044;133;22177
RN;24;11601;São Bento do Norte;3292;12;3304
RN;24;11700;São Bento do Trairí;3765;27;3792
RN;24;11809;São Fernando;3484;8;3492
RN;24;11908;São Francisco do Oeste;4126;35;4161
RN;24;12005;São Gonçalo do Amarante;112518;3320;115838
RN;24;12104;São João do Sabugi;5956;0;5956
RN;24;12203;São José de Mipibu;45901;1385;47286
RN;24;12302;São José do Campestre;11099;22;11121
RN;24;12401;São José do Seridó;4550;8;4558
RN;24;12500;São Miguel;23039;498;23537
RN;24;12559;São Miguel do Gostoso;9952;269;10221
RN;24;12609;São Paulo do Potengi;16575;211;16786
RN;24;12708;São Pedro;5698;78;5776
RN;24;12807;São Rafael;7711;0;7711
RN;24;12906;São Tomé;9814;158;9972
RN;24;13003;São Vicente;6277;33;6310
RN;24;13102;Senador Elói de Souza;5955;10;5965
RN;24;13201;Senador Georgino Avelino;3953;112;4065
RN;24;13300;Serra de São Bento;5648;55;5703
RN;24;13359;Serra do Mel;12953;138;13091
RN;24;13409;Serra Negra do Norte;7560;37;7597
RN;24;13508;Serrinha;6411;25;6436
RN;24;13557;Serrinha dos Pintos;4656;3;4659
RN;24;13607;Severiano Melo;5452;35;5487
RN;24;13706;Sítio Novo;4651;3;4654
RN;24;13805;Taboleiro Grande;2324;14;2338
RN;24;13904;Taipu;11362;60;11422
RN;24;14001;Tangará;13163;118;13281
RN;24;14100;Tenente Ananias;10262;0;10262
RN;24;14159;Tenente Laurentino Cruz;5889;2;5891
RN;24;14209;Tibau do Sul;16213;716;16929
RN;24;14308;Timbaúba dos Batistas;2339;9;2348
RN;24;14407;Touros;32529;506;33035
RN;24;14456;Triunfo Potiguar;3324;34;3358
RN;24;14506;Umarizal;10057;21;10078
RN;24;14605;Upanema;13473;99;13572
RN;24;14704;Várzea;5189;44;5233
RN;24;14753;Venha-Ver;3007;7;3014
RN;24;14803;Vera Cruz;10242;434;10676
RN;24;14902;Viçosa;1822;0;1822
RN;24;15008;Vila Flor;3174;0;3174
PB;25;00106;Água Branca;9299;36;9335
PB;25;00205;Aguiar;5003;0;5003
PB;25;00304;Alagoa Grande;26040;22;26062
PB;25;00403;Alagoa Nova;21013;0;21013
PB;25;00502;Alagoinha;13721;4;13725
PB;25;00536;Alcantil;5578;0;5578
PB;25;00577;Algodão de Jandaíra;2953;0;2953
PB;25;00601;Alhandra;21577;136;21713
PB;25;00700;São João do Rio do Peixe;17964;0;17964
PB;25;00734;Amparo;2190;44;2234
PB;25;00775;Aparecida;7955;5;7960
PB;25;00809;Araçagi;16634;12;16646
PB;25;00908;Arara;12188;24;12212
PB;25;01005;Araruna;17151;38;17189
PB;25;01104;Areia;22633;0;22633
PB;25;01153;Areia de Baraúnas;2005;0;2005
PB;25;01203;Areial;7038;90;7128
PB;25;01302;Aroeiras;18679;26;18705
PB;25;01351;Assunção;4152;0;4152
PB;25;01401;Baía da Traição;9080;144;9224
PB;25;01500;Bananeiras;23124;10;23134
PB;25;01534;Baraúna;4748;14;4762
PB;25;01575;Barra de Santana;8059;0;8059
PB;25;01609;Barra de Santa Rosa;12880;24;12904
PB;25;01708;Barra de São Miguel;5900;6;5906
PB;25;01807;Bayeux;81246;1496;82742
PB;25;01906;Belém;16401;0;16401
PB;25;02003;Belém do Brejo do Cruz;6268;0;6268
PB;25;02052;Bernardino Batista;3504;0;3504
PB;25;02102;Boa Ventura;5199;8;5207
PB;25;02151;Boa Vista;6343;34;6377
PB;25;02201;Bom Jesus;2283;3;2286
PB;25;02300;Bom Sucesso;4651;10;4661
PB;25;02409;Bonito de Santa Fé;10215;37;10252
PB;25;02508;Boqueirão;17587;11;17598
PB;25;02607;Igaracy;5627;21;5648
PB;25;02706;Borborema;4212;2;4214
PB;25;02805;Brejo do Cruz;13613;0;13613
PB;25;02904;Brejo dos Santos;5735;7;5742
PB;25;03001;Caaporã;20687;506;21193
PB;25;03100;Cabaceiras;5335;0;5335
PB;25;03209;Cabedelo;64002;2517;66519
PB;25;03308;Cachoeira dos Índios;9132;19;9151
PB;25;03407;Cacimba de Areia;3289;2;3291
PB;25;03506;Cacimba de Dentro;16064;0;16064
PB;25;03555;Cacimbas;7221;2;7223
PB;25;03605;Caiçara;6600;2;6602
PB;25;03704;Cajazeiras;62237;1002;63239
PB;25;03753;Cajazeirinhas;2730;10;2740
PB;25;03803;Caldas Brandão;5749;4;5753
PB;25;03902;Camalaú;6055;30;6085
PB;25;04009;Campina Grande;413517;5862;419379
PB;25;04033;Capim;6939;31;6970
PB;25;04074;Caraúbas;3944;0;3944
PB;25;04108;Carrapateira;2304;8;2312
PB;25;04157;Casserengue;6889;0;6889
PB;25;04207;Catingueira;4488;3;4491
PB;25;04306;Catolé do Rocha;30621;40;30661
PB;25;04355;Caturité;5253;1;5254
PB;25;04405;Conceição;18249;11;18260
PB;25;04504;Condado;6416;35;6451
PB;25;04603;Conde;27472;133;27605
PB;25;04702;Congo;4919;14;4933
PB;25;04801;Coremas;14614;69;14683
PB;25;04850;Coxixola;1824;0;1824
PB;25;04900;Cruz do Espírito Santo;16986;109;17095
PB;25;05006;Cubati;7573;7;7580
PB;25;05105;Cuité;19515;204;19719
PB;25;05204;Cuitegi;6730;0;6730
PB;25;05238;Cuité de Mamanguape;6241;10;6251
PB;25;05279;Curral de Cima;5244;10;5254
PB;25;05303;Curral Velho;2292;0;2292
PB;25;05352;Damião;4974;8;4982
PB;25;05402;Desterro;8045;22;8067
PB;25;05501;Vista Serrana;3640;1;3641
PB;25;05600;Diamante;6299;0;6299
PB;25;05709;Dona Inês;10380;0;10380
PB;25;05808;Duas Estradas;3327;0;3327
PB;25;05907;Emas;3010;1;3011
PB;25;06004;Esperança;30946;285;31231
PB;25;06103;Fagundes;11048;1;11049
PB;25;06202;Frei Martinho;2846;0;2846
PB;25;06251;Gado Bravo;8179;0;8179
PB;25;06301;Guarabira;57454;30;57484
PB;25;06400;Gurinhém;13751;15;13766
PB;25;06509;Gurjão;3242;0;3242
PB;25;06608;Ibiara;5628;3;5631
PB;25;06707;Imaculada;10350;42;10392
PB;25;06806;Ingá;17689;3;17692
PB;25;06905;Itabaiana;23132;50;23182
PB;25;07002;Itaporanga;23784;156;23940
PB;25;07101;Itapororoca;18381;1;18382
PB;25;07200;Itatuba;10439;60;10499
PB;25;07309;Jacaraú;13930;372;14302
PB;25;07408;Jericó;7508;8;7516
PB;25;07507;João Pessoa;804411;29521;833932
PB;25;07606;Juarez Távora;7796;0;7796
PB;25;07705;Juazeirinho;16997;10;17007
PB;25;07804;Junco do Seridó;6783;10;6793
PB;25;07903;Juripiranga;9790;222;10012
PB;25;08000;Juru;9215;19;9234
PB;25;08109;Lagoa;4396;19;4415
PB;25;08208;Lagoa de Dentro;7819;0;7819
PB;25;08307;Lagoa Seca;27646;84;27730
PB;25;08406;Lastro;3162;0;3162
PB;25;08505;Livramento;6872;5;6877
PB;25;08554;Logradouro;4797;0;4797
PB;25;08604;Lucena;12275;285;12560
PB;25;08703;Mãe d'Água;3583;0;3583
PB;25;08802;Malta;6039;7;6046
PB;25;08901;Mamanguape;43873;726;44599
PB;25;09008;Manaíra;10378;56;10434
PB;25;09057;Marcação;8943;56;8999
PB;25;09107;Mari;21184;328;21512
PB;25;09156;Marizópolis;6701;4;6705
PB;25;09206;Massaranduba;14131;8;14139
PB;25;09305;Mataraca;8077;167;8244
PB;25;09339;Matinhas;4568;3;4571
PB;25;09370;Mato Grosso;2539;4;2543
PB;25;09396;Maturéia;6352;81;6433
PB;25;09404;Mogeiro;13899;0;13899
PB;25;09503;Montadas;5800;12;5812
PB;25;09602;Monte Horebe;4338;0;4338
PB;25;09701;Monteiro;32051;226;32277
PB;25;09800;Mulungu;8786;5;8791
PB;25;09909;Natuba;8944;1;8945
PB;25;10006;Nazarezinho;7201;2;7203
PB;25;10105;Nova Floresta;9596;128;9724
PB;25;10204;Nova Olinda;5787;0;5787
PB;25;10303;Nova Palmeira;4259;0;4259
PB;25;10402;Olho d'Água;6058;2;6060
PB;25;10501;Olivedos;3570;10;3580
PB;25;10600;Ouro Velho;2918;0;2918
PB;25;10659;Parari;1720;0;1720
PB;25;10709;Passagem;2463;0;2463
PB;25;10808;Patos;100397;2768;103165
PB;25;10907;Paulista;11827;7;11834
PB;25;11004;Pedra Branca;3730;9;3739
PB;25;11103;Pedra Lavrada;6850;9;6859
PB;25;11202;Pedras de Fogo;29208;454;29662
PB;25;11301;Piancó;16413;28;16441
PB;25;11400;Picuí;18282;51;18333
PB;25;11509;Pilar;12276;35;12311
PB;25;11608;Pilões;6815;0;6815
PB;25;11707;Pilõezinhos;5329;0;5329
PB;25;11806;Pirpirituba;9323;17;9340
PB;25;11905;Pitimbu;16402;349;16751
PB;25;12002;Pocinhos;17411;58;17469
PB;25;12036;Poço Dantas;3830;0;3830
PB;25;12077;Poço de José de Moura;4003;3;4006
PB;25;12101;Pombal;32284;189;32473
PB;25;12200;Prata;3913;2;3915
PB;25;12309;Princesa Isabel;21105;9;21114
PB;25;12408;Puxinanã;14270;7;14277
PB;25;12507;Queimadas;47538;120;47658
PB;25;12606;Quixaba;1732;11;1743
PB;25;12705;Remígio;17866;19;17885
PB;25;12721;Pedro Régis;5644;122;5766
PB;25;12747;Riachão;2927;0;2927
PB;25;12754;Riachão do Bacamarte;4683;7;4690
PB;25;12762;Riachão do Poço;4711;27;4738
PB;25;12788;Riacho de Santo Antônio;1950;5;1955
PB;25;12804;Riacho dos Cavalos;8413;80;8493
PB;25;12903;Rio Tinto;24144;437;24581
PB;25;13000;Salgadinho;3345;10;3355
PB;25;13109;Salgado de São Félix;11490;15;11505
PB;25;13158;Santa Cecília;7662;8;7670
PB;25;13208;Santa Cruz;5947;0;5947
PB;25;13307;Santa Helena;5863;2;5865
PB;25;13356;Santa Inês;3227;0;3227
PB;25;13406;Santa Luzia;14945;14;14959
PB;25;13505;Santana de Mangueira;5010;0;5010
PB;25;13604;Santana dos Garrotes;6564;5;6569
PB;25;13653;Joca Claudino;2539;0;2539
PB;25;13703;Santa Rita;145093;4817;149910
PB;25;13802;Santa Teresinha;4297;105;4402
PB;25;13851;Santo André;2622;0;2622
PB;25;13901;São Bento;32107;128;32235
PB;25;13927;São Bentinho;4324;3;4327
PB;25;13943;São Domingos do Cariri;2585;0;2585
PB;25;13968;São Domingos;2595;0;2595
PB;25;13984;São Francisco;3137;0;3137
PB;25;14008;São João do Cariri;4211;15;4226
PB;25;14107;São João do Tigre;4261;2;4263
PB;25;14206;São José da Lagoa Tapada;7126;0;7126
PB;25;14305;São José de Caiana;5033;1;5034
PB;25;14404;São José de Espinharas;4051;32;4083
PB;25;14453;São José dos Ramos;5871;20;5891
PB;25;14503;São José de Piranhas;18839;228;19067
PB;25;14552;São José de Princesa;3409;7;3416
PB;25;14602;São José do Bonfim;3242;0;3242
PB;25;14651;São José do Brejo do Cruz;1699;0;1699
PB;25;14701;São José do Sabugi;4136;2;4138
PB;25;14800;São José dos Cordeiros;3411;0;3411
PB;25;14909;São Mamede;7460;10;7470
PB;25;15005;São Miguel de Taipu;7060;6;7066
PB;25;15104;São Sebastião de Lagoa de Roça;11028;12;11040
PB;25;15203;São Sebastião do Umbuzeiro;3279;0;3279
PB;25;15302;Sapé;50508;798;51306
PB;25;15401;São Vicente do Seridó;10282;9;10291
PB;25;15500;Serra Branca;13602;12;13614
PB;25;15609;Serra da Raiz;3094;0;3094
PB;25;15708;Serra Grande;2942;0;2942
PB;25;15807;Serra Redonda;6826;2;6828
PB;25;15906;Serraria;4885;0;4885
PB;25;15930;Sertãozinho;5054;0;5054
PB;25;15971;Sobrado;8225;11;8236
PB;25;16003;Solânea;26705;69;26774
PB;25;16102;Soledade;13946;22;13968
PB;25;16151;Sossêgo;3345;0;3345
PB;25;16201;Sousa;66314;945;67259
PB;25;16300;Sumé;16935;231;17166
PB;25;16409;Tacima;8010;0;8010
PB;25;16508;Taperoá;13936;132;14068
PB;25;16607;Tavares;14061;40;14101
PB;25;16706;Teixeira;14476;155;14631
PB;25;16755;Tenório;2966;0;2966
PB;25;16805;Triunfo;9892;0;9892
PB;25;16904;Uiraúna;14915;15;14930
PB;25;17001;Umbuzeiro;9124;0;9124
PB;25;17100;Várzea;2668;0;2668
PB;25;17209;Vieirópolis;4864;0;4864
PB;25;17407;Zabelê;2223;5;2228
PE;26;00054;Abreu e Lima;94284;4178;98462
PE;26;00104;Afogados da Ingazeira;39986;255;40241
PE;26;00203;Afrânio;18595;79;18674
PE;26;00302;Agrestina;23154;625;23779
PE;26;00401;Água Preta;26370;91;26461
PE;26;00500;Águas Belas;40726;822;41548
PE;26;00609;Alagoinha;13138;404;13542
PE;26;00708;Aliança;35728;13;35741
PE;26;00807;Altinho;20128;546;20674
PE;26;00906;Amaraji;18149;56;18205
PE;26;01003;Angelim;10087;154;10241
PE;26;01052;Araçoiaba;18695;548;19243
PE;26;01102;Araripina;82450;2638;85088
PE;26;01201;Arcoverde;74511;3075;77586
PE;26;01300;Barra de Guabiraba;12234;29;12263
PE;26;01409;Barreiros;39968;153;40121
PE;26;01508;Belém de Maria;10343;35;10378
PE;26;01607;Belém do São Francisco;18156;145;18301
PE;26;01706;Belo Jardim;77379;2128;79507
PE;26;01805;Betânia;11114;118;11232
PE;26;01904;Bezerros;59159;2527;61686
PE;26;02001;Bodocó;34306;172;34478
PE;26;02100;Bom Conselho;43354;906;44260
PE;26;02209;Bom Jardim;37566;63;37629
PE;26;02308;Bonito;35934;1542;37476
PE;26;02407;Brejão;9048;31;9079
PE;26;02506;Brejinho;7716;4;7720
PE;26;02605;Brejo da Madre de Deus;47333;1317;48650
PE;26;02704;Buenos Aires;12601;207;12808
PE;26;02803;Buíque;50278;1819;52097
PE;26;02902;Cabo de Santo Agostinho;194602;8614;203216
PE;26;03009;Cabrobó;29046;1248;30294
PE;26;03108;Cachoeirinha;19337;562;19899
PE;26;03207;Caetés;28723;104;28827
PE;26;03306;Calçado;11005;88;11093
PE;26;03405;Calumbi;5209;19;5228
PE;26;03454;Camaragibe;141981;5790;147771
PE;26;03504;Camocim de São Félix;16933;486;17419
PE;26;03603;Camutanga;7664;86;7750
PE;26;03702;Canhotinho;24219;110;24329
PE;26;03801;Capoeiras;18165;176;18341
PE;26;03900;Carnaíba;18587;57;18644
PE;26;03926;Carnaubeira da Penha;12228;11;12239
PE;26;04007;Carpina;77285;2008;79293
PE;26;04106;Caruaru;362641;15411;378052
PE;26;04155;Casinhas;12856;111;12967
PE;26;04205;Catende;31989;167;32156
PE;26;04304;Cedro;10502;16;10518
PE;26;04403;Chã de Alegria;12824;156;12980
PE;26;04502;Chã Grande;19894;652;20546
PE;26;04601;Condado;24140;447;24587
PE;26;04700;Correntes;17044;87;17131
PE;26;04809;Cortês;10169;29;10198
PE;26;04908;Cumaru;15886;34;15920
PE;26;05004;Cupira;22976;542;23518
PE;26;05103;Custódia;35950;1749;37699
PE;26;05152;Dormentes;17143;45;17188
PE;26;05202;Escada;59316;520;59836
PE;26;05301;Exu;31604;239;31843
PE;26;05400;Feira Nova;20853;574;21427
PE;26;05459;Fernando de Noronha;2794;373;3167
PE;26;05509;Ferreiros;14937;89;15026
PE;26;05608;Flores;20235;112;20347
PE;26;05707;Floresta;29670;474;30144
PE;26;05806;Frei Miguelinho;13633;3;13636
PE;26;05905;Gameleira;18147;67;18214
PE;26;06002;Garanhuns;137067;5439;142506
PE;26;06101;Glória do Goitá;28975;372;29347
PE;26;06200;Goiana;78470;2572;81042
PE;26;06309;Granito;6919;48;6967
PE;26;06408;Gravatá;82433;4083;86516
PE;26;06507;Iati;17106;59;17165
PE;26;06606;Ibimirim;26222;373;26595
PE;26;06705;Ibirajuba;7101;39;7140
PE;26;06804;Igarassu;110711;4485;115196
PE;26;06903;Iguaracy;11016;66;11082
PE;26;07000;Inajá;25357;242;25599
PE;26;07109;Ingazeira;4765;3;4768
PE;26;07208;Ipojuca;95917;3015;98932
PE;26;07307;Ipubi;28831;178;29009
PE;26;07406;Itacuruba;4207;77;4284
PE;26;07505;Itaíba;32519;131;32650
PE;26;07604;Ilha de Itamaracá;23873;667;24540
PE;26;07653;Itambé;34881;54;34935
PE;26;07703;Itapetim;13784;4;13788
PE;26;07752;Itapissuma;26911;838;27749
PE;26;07802;Itaquitinga;16517;37;16554
PE;26;07901;Jaboatão dos Guararapes;620175;23584;643759
PE;26;07950;Jaqueira;10231;16;10247
PE;26;08008;Jataúba;15305;538;15843
PE;26;08057;Jatobá;13715;305;14020
PE;26;08107;João Alfredo;27426;299;27725
PE;26;08206;Joaquim Nabuco;13202;67;13269
PE;26;08255;Jucati;11376;141;11517
PE;26;08305;Jupi;15119;210;15329
PE;26;08404;Jurema;13612;36;13648
PE;26;08453;Lagoa do Carro;17186;795;17981
PE;26;08503;Lagoa de Itaenga;18655;348;19003
PE;26;08602;Lagoa do Ouro;11917;16;11933
PE;26;08701;Lagoa dos Gatos;13719;354;14073
PE;26;08750;Lagoa Grande;23297;791;24088
PE;26;08800;Lajedo;38534;1048;39582
PE;26;08909;Limoeiro;55632;878;56510
PE;26;09006;Macaparana;23854;25;23879
PE;26;09105;Machados;11179;154;11333
PE;26;09154;Manari;23175;588;23763
PE;26;09204;Maraial;9265;94;9359
PE;26;09303;Mirandiba;14122;44;14166
PE;26;09402;Moreno;52895;2373;55268
PE;26;09501;Nazaré da Mata;29788;860;30648
PE;26;09600;Olinda;335880;14096;349976
PE;26;09709;Orobó;21339;469;21808
PE;26;09808;Orocó;13388;225;13613
PE;26;09907;Ouricuri;64228;1017;65245
PE;26;10004;Palmares;53587;997;54584
PE;26;10103;Palmeirina;7031;0;7031
PE;26;10202;Panelas;22688;303;22991
PE;26;10301;Paranatama;12103;96;12199
PE;26;10400;Parnamirim;18608;4;18612
PE;26;10509;Passira;28266;74;28340
PE;26;10608;Paudalho;54624;2035;56659
PE;26;10707;Paulista;328154;14013;342167
PE;26;10806;Pedra;21783;1012;22795
PE;26;10905;Pesqueira;61073;1649;62722
PE;26;11002;Petrolândia;33764;397;34161
PE;26;11101;Petrolina;371654;15132;386786
PE;26;11200;Poção;10402;98;10500
PE;26;11309;Pombos;26488;1064;27552
PE;26;11408;Primavera;13838;0;13838
PE;26;11507;Quipapá;17922;7;17929
PE;26;11533;Quixaba;6550;4;6554
PE;26;11606;Recife;1427951;60969;1488920
PE;26;11705;Riacho das Almas;20235;400;20635
PE;26;11804;Ribeirão;33438;69;33507
PE;26;11903;Rio Formoso;19993;16;20009
PE;26;12000;Sairé;10608;279;10887
PE;26;12109;Salgadinho;5660;67;5727
PE;26;12208;Salgueiro;61016;1356;62372
PE;26;12307;Saloá;13657;179;13836
PE;26;12406;Sanharó;18308;316;18624
PE;26;12455;Santa Cruz;13798;43;13841
PE;26;12471;Santa Cruz da Baixa Verde;11479;88;11567
PE;26;12505;Santa Cruz do Capibaribe;94660;3594;98254
PE;26;12554;Santa Filomena;12026;80;12106
PE;26;12604;Santa Maria da Boa Vista;39860;718;40578
PE;26;12703;Santa Maria do Cambucá;13617;396;14013
PE;26;12802;Santa Terezinha;10229;15;10244
PE;26;12901;São Benedito do Sul;13104;9;13113
PE;26;13008;São Bento do Una;48615;833;49448
PE;26;13107;São Caitano;36162;964;37126
PE;26;13206;São João;23499;336;23835
PE;26;13305;São Joaquim do Monte;19752;285;20037
PE;26;13404;São José da Coroa Grande;18675;150;18825
PE;26;13503;São José do Belmonte;34487;356;34843
PE;26;13602;São José do Egito;30858;146;31004
PE;26;13701;São Lourenço da Mata;108870;2373;111243
PE;26;13800;São Vicente Férrer;16648;29;16677
PE;26;13909;Serra Talhada;89569;2659;92228
PE;26;14006;Serrita;18099;108;18207
PE;26;14105;Sertânia;31451;1360;32811
PE;26;14204;Sirinhaém;36904;692;37596
PE;26;14303;Moreilândia;10540;0;10540
PE;26;14402;Solidão;5203;7;5210
PE;26;14501;Surubim;62495;1625;64120
PE;26;14600;Tabira;27472;209;27681
PE;26;14709;Tacaimbó;13547;191;13738
PE;26;14808;Tacaratu;23343;559;23902
PE;26;14857;Tamandaré;23189;372;23561
PE;26;15003;Taquaritinga do Norte;24077;659;24736
PE;26;15102;Terezinha;6463;50;6513
PE;26;15201;Terra Nova;8907;13;8920
PE;26;15300;Timbaúba;45804;343;46147
PE;26;15409;Toritama;39336;1801;41137
PE;26;15508;Tracunhaém;13747;120;13867
PE;26;15607;Trindade;29862;459;30321
PE;26;15706;Triunfo;14561;144;14705
PE;26;15805;Tupanatinga;26129;811;26940
PE;26;15904;Tuparetama;7994;11;8005
PE;26;16001;Venturosa;16441;810;17251
PE;26;16100;Verdejante;9167;2;9169
PE;26;16183;Vertente do Lério;7558;0;7558
PE;26;16209;Vertentes;20938;1021;21959
PE;26;16308;Vicência;25683;676;26359
PE;26;16407;Vitória de Santo Antão;128154;5956;134110
PE;26;16506;Xexéu;11526;85;11611
AL;27;00102;Água Branca;19007;1;19008
AL;27;00201;Anadia;13794;17;13811
AL;27;00300;Arapiraca;228702;5994;234696
AL;27;00409;Atalaia;37365;147;37512
AL;27;00508;Barra de Santo Antônio;16241;124;16365
AL;27;00607;Barra de São Miguel;7864;80;7944
AL;27;00706;Batalha;16415;33;16448
AL;27;00805;Belém;4707;15;4722
AL;27;00904;Belo Monte;5918;18;5936
AL;27;01001;Boca da Mata;21036;151;21187
AL;27;01100;Branquinha;9603;0;9603
AL;27;01209;Cacimbinhas;10476;0;10476
AL;27;01308;Cajueiro;15834;190;16024
AL;27;01357;Campestre;6662;3;6665
AL;27;01407;Campo Alegre;32021;85;32106
AL;27;01506;Campo Grande;8141;1;8142
AL;27;01605;Canapi;15500;59;15559
AL;27;01704;Capela;15030;2;15032
AL;27;01803;Carneiros;8952;47;8999
AL;27;01902;Chã Preta;5899;11;5910
AL;27;02009;Coité do Nóia;10748;62;10810
AL;27;02108;Colônia Leopoldina;15643;173;15816
AL;27;02207;Coqueiro Seco;5490;91;5581
AL;27;02306;Coruripe;49861;553;50414
AL;27;02355;Craíbas;25390;7;25397
AL;27;02405;Delmiro Gouveia;50629;690;51319
AL;27;02504;Dois Riachos;9746;59;9805
AL;27;02553;Estrela de Alagoas;15418;11;15429
AL;27;02603;Feira Grande;22381;331;22712
AL;27;02702;Feliz Deserto;3961;2;3963
AL;27;02801;Flexeiras;9590;28;9618
AL;27;02900;Girau do Ponciano;35902;200;36102
AL;27;03007;Ibateguara;13635;96;13731
AL;27;03106;Igaci;23991;4;23995
AL;27;03205;Igreja Nova;21302;70;21372
AL;27;03304;Inhapi;15159;8;15167
AL;27;03403;Jacaré dos Homens;5065;18;5083
AL;27;03502;Jacuípe;5301;51;5352
AL;27;03601;Japaratinga;9065;154;9219
AL;27;03700;Jaramataia;4975;10;4985
AL;27;03759;Jequiá da Praia;9361;109;9470
AL;27;03809;Joaquim Gomes;17057;95;17152
AL;27;03908;Jundiá;4093;0;4093
AL;27;04005;Junqueiro;23805;102;23907
AL;27;04104;Lagoa da Canoa;18167;290;18457
AL;27;04203;Limoeiro de Anadia;24700;40;24740
AL;27;04302;Maceió;923491;34425;957916
AL;27;04401;Major Isidoro;17657;43;17700
AL;27;04500;Maragogi;31840;334;32174
AL;27;04609;Maravilha;9472;62;9534
AL;27;04708;Marechal Deodoro;58325;2045;60370
AL;27;04807;Maribondo;13667;12;13679
AL;27;04906;Mar Vermelho;3155;0;3155
AL;27;05002;Mata Grande;21756;88;21844
AL;27;05101;Matriz de Camaragibe;23834;23;23857
AL;27;05200;Messias;15185;220;15405
AL;27;05309;Minador do Negrão;4845;0;4845
AL;27;05408;Monteirópolis;7125;59;7184
AL;27;05507;Murici;24911;276;25187
AL;27;05606;Novo Lino;10005;19;10024
AL;27;05705;Olho d'Água das Flores;20349;346;20695
AL;27;05804;Olho d'Água do Casado;8314;35;8349
AL;27;05903;Olho d'Água Grande;4317;13;4330
AL;27;06000;Olivença;10625;187;10812
AL;27;06109;Ouro Branco;11258;188;11446
AL;27;06208;Palestina;4318;7;4325
AL;27;06307;Palmeira dos Índios;70451;1123;71574
AL;27;06406;Pão de Açúcar;23480;343;23823
AL;27;06422;Pariconha;10573;0;10573
AL;27;06448;Paripueira;13447;388;13835
AL;27;06505;Passo de Camaragibe;13648;156;13804
AL;27;06604;Paulo Jacinto;6576;0;6576
AL;27;06703;Penedo;57373;1274;58647
AL;27;06802;Piaçabuçu;15873;24;15897
AL;27;06901;Pilar;34671;699;35370
AL;27;07008;Pindoba;2723;8;2731
AL;27;07107;Piranhas;22382;227;22609
AL;27;07206;Poço das Trincheiras;12378;140;12518
AL;27;07305;Porto Calvo;23777;294;24071
AL;27;07404;Porto de Pedras;9242;53;9295
AL;27;07503;Porto Real do Colégio;19888;191;20079
AL;27;07602;Quebrangulo;11080;0;11080
AL;27;07701;Rio Largo;91570;2357;93927
AL;27;07800;Roteiro;6455;19;6474
AL;27;07909;Santa Luzia do Norte;6779;140;6919
AL;27;08006;Santana do Ipanema;45442;778;46220
AL;27;08105;Santana do Mundaú;11305;18;11323
AL;27;08204;São Brás;6512;43;6555
AL;27;08303;São José da Laje;20773;40;20813
AL;27;08402;São José da Tapera;30180;424;30604
AL;27;08501;São Luís do Quitunde;30618;255;30873
AL;27;08600;São Miguel dos Campos;50750;1240;51990
AL;27;08709;São Miguel dos Milagres;8312;170;8482
AL;27;08808;São Sebastião;31598;188;31786
AL;27;08907;Satuba;23327;951;24278
AL;27;08956;Senador Rui Palmeira;12273;29;12302
AL;27;09004;Tanque d'Arca;5762;34;5796
AL;27;09103;Taquarana;19008;24;19032
AL;27;09152;Teotônio Vilela;37816;237;38053
AL;27;09202;Traipu;23526;39;23565
AL;27;09301;União dos Palmares;58837;443;59280
AL;27;09400;Viçosa;24078;14;24092
SE;28;00100;Amparo do São Francisco;2161;9;2170
SE;28;00209;Aquidabã;20131;0;20131
SE;28;00308;Aracaju;577729;25028;602757
SE;28;00407;Arauá;10208;110;10318
SE;28;00506;Areia Branca;17900;181;18081
SE;28;00605;Barra dos Coqueiros;40422;1089;41511
SE;28;00670;Boquim;24244;394;24638
SE;28;00704;Brejo Grande;7793;48;7841
SE;28;01009;Campo do Brito;17849;300;18149
SE;28;01108;Canhoba;3776;15;3791
SE;28;01207;Canindé de São Francisco;26570;264;26834
SE;28;01306;Capela;31355;290;31645
SE;28;01405;Carira;19705;234;19939
SE;28;01504;Carmópolis;13679;174;13853
SE;28;01603;Cedro de São João;5362;29;5391
SE;28;01702;Cristinápolis;16787;313;17100
SE;28;01900;Cumbe;3803;21;3824
SE;28;02007;Divina Pastora;4281;59;4340
SE;28;02106;Estância;63400;1678;65078
SE;28;02205;Feira Nova;5966;9;5975
SE;28;02304;Frei Paulo;14371;159;14530
SE;28;02403;Gararu;11087;9;11096
SE;28;02502;General Maynard;3032;5;3037
SE;28;02601;Gracho Cardoso;5829;5;5834
SE;28;02700;Ilha das Flores;8295;26;8321
SE;28;02809;Indiaroba;16438;111;16549
SE;28;02908;Itabaiana;99749;3690;103439
SE;28;03005;Itabaianinha;39343;1335;40678
SE;28;03104;Itabi;4743;2;4745
SE;28;03203;Itaporanga d'Ajuda;33980;431;34411
SE;28;03302;Japaratuba;16102;107;16209
SE;28;03401;Japoatã;13355;52;13407
SE;28;03500;Lagarto;99817;1762;101579
SE;28;03609;Laranjeiras;23857;118;23975
SE;28;03708;Macambira;6716;122;6838
SE;28;03807;Malhada dos Bois;3571;8;3579
SE;28;03906;Malhador;11303;230;11533
SE;28;04003;Maruim;15342;377;15719
SE;28;04102;Moita Bonita;10842;208;11050
SE;28;04201;Monte Alegre de Sergipe;14281;55;14336
SE;28;04300;Muribeca;7787;35;7822
SE;28;04409;Neópolis;16394;32;16426
SE;28;04458;Nossa Senhora Aparecida;9084;148;9232
SE;28;04508;Nossa Senhora da Glória;40507;695;41202
SE;28;04607;Nossa Senhora das Dores;24849;147;24996
SE;28;04706;Nossa Senhora de Lourdes;6268;0;6268
SE;28;04805;Nossa Senhora do Socorro;186684;5646;192330
SE;28;04904;Pacatuba;12234;268;12502
SE;28;05000;Pedra Mole;2737;41;2778
SE;28;05109;Pedrinhas;7336;60;7396
SE;28;05208;Pinhão;5663;14;5677
SE;28;05307;Pirambu;7849;64;7913
SE;28;05406;Poço Redondo;33128;311;33439
SE;28;05505;Poço Verde;21395;399;21794
SE;28;05604;Porto da Folha;26296;280;26576
SE;28;05703;Propriá;26388;230;26618
SE;28;05802;Riachão do Dantas;18073;240;18313
SE;28;05901;Riachuelo;8260;51;8311
SE;28;06008;Ribeirópolis;16760;273;17033
SE;28;06107;Rosário do Catete;9175;120;9295
SE;28;06206;Salgado;20115;164;20279
SE;28;06305;Santa Luzia do Itanhy;13401;215;13616
SE;28;06404;Santana do São Francisco;7343;3;7346
SE;28;06503;Santa Rosa de Lima;3891;46;3937
SE;28;06602;Santo Amaro das Brotas;10832;260;11092
SE;28;06701;São Cristóvão;92998;2614;95612
SE;28;06800;São Domingos;10277;50;10327
SE;28;06909;São Francisco;3231;12;3243
SE;28;07006;São Miguel do Aleixo;3372;62;3434
SE;28;07105;Simão Dias;41877;701;42578
SE;28;07204;Siriri;7817;17;7834
SE;28;07303;Telha;3258;16;3274
SE;28;07402;Tobias Barreto;49879;1026;50905
SE;28;07501;Tomar do Geru;11941;71;12012
SE;28;07600;Umbaúba;23362;555;23917
BA;29;00108;Abaíra;7096;205;7301
BA;29;00207;Abaré;17478;161;17639
BA;29;00306;Acajutiba;13788;7;13795
BA;29;00355;Adustina;14138;62;14200
BA;29;00405;Água Fria;14081;416;14497
BA;29;00504;Érico Cardoso;10578;26;10604
BA;29;00603;Aiquara;4435;11;4446
BA;29;00702;Alagoinhas;145451;5614;151065
BA;29;00801;Alcobaça;24301;229;24530
BA;29;00900;Almadina;5207;11;5218
BA;29;01007;Amargosa;36106;416;36522
BA;29;01106;Amélia Rodrigues;23084;1054;24138
BA;29;01155;América Dourada;15055;82;15137
BA;29;01205;Anagé;25319;119;25438
BA;29;01304;Andaraí;13044;36;13080
BA;29;01353;Andorinha;14932;80;15012
BA;29;01403;Angical;13690;42;13732
BA;29;01502;Anguera;11009;22;11031
BA;29;01601;Antas;14037;169;14206
BA;29;01700;Antônio Cardoso;11124;22;11146
BA;29;01809;Antônio Gonçalves;10787;75;10862
BA;29;01908;Aporá;15775;155;15930
BA;29;01957;Apuarema;6890;23;6913
BA;29;02005;Aracatu;13859;77;13936
BA;29;02054;Araçás;11397;160;11557
BA;29;02104;Araci;47307;728;48035
BA;29;02203;Aramari;9764;69;9833
BA;29;02252;Arataca;10187;4;10191
BA;29;02302;Aratuípe;8418;259;8677
BA;29;02401;Aurelino Leal;11057;122;11179
BA;29;02500;Baianópolis;13606;8;13614
BA;29;02609;Baixa Grande;18137;83;18220
BA;29;02658;Banzaê;11938;20;11958
BA;29;02708;Barra;50956;136;51092
BA;29;02807;Barra da Estiva;25766;260;26026
BA;29;02906;Barra do Choça;36361;178;36539
BA;29;03003;Barra do Mendes;13769;67;13836
BA;29;03102;Barra do Rocha;5707;67;5774
BA;29;03201;Barreiras;155429;4314;159743
BA;29;03235;Barro Alto;13332;121;13453
BA;29;03276;Barrocas;15142;61;15203
BA;29;03300;Barro Preto;5414;169;5583
BA;29;03409;Belmonte;19748;373;20121
BA;29;03508;Belo Campo;18327;85;18412
BA;29;03607;Biritinga;15115;31;15146
BA;29;03706;Boa Nova;13667;23;13690
BA;29;03805;Boa Vista do Tupim;16786;87;16873
BA;29;03904;Bom Jesus da Lapa;65115;435;65550
BA;29;03953;Bom Jesus da Serra;9730;0;9730
BA;29;04001;Boninal;13442;180;13622
BA;29;04050;Bonito;15751;93;15844
BA;29;04100;Boquira;19098;224;19322
BA;29;04209;Botuporã;10907;117;11024
BA;29;04308;Brejões;12755;188;12943
BA;29;04407;Brejolândia;9092;16;9108
BA;29;04506;Brotas de Macaúbas;11725;40;11765
BA;29;04605;Brumado;69392;1120;70512
BA;29;04704;Buerarema;14710;94;14804
BA;29;04753;Buritirama;19554;35;19589
BA;29;04803;Caatiba;6171;34;6205
BA;29;04852;Cabaceiras do Paraguaçu;16485;74;16559
BA;29;04902;Cachoeira;29043;208;29251
BA;29;05008;Caculé;22222;240;22462
BA;29;05107;Caém;10369;15;10384
BA;29;05156;Caetanos;11207;59;11266
BA;29;05206;Caetité;51121;891;52012
BA;29;05305;Cafarnaum;17167;299;17466
BA;29;05404;Cairu;16940;821;17761
BA;29;05503;Caldeirão Grande;12895;185;13080
BA;29;05602;Camacan;22091;487;22578
BA;29;05701;Camaçari;290419;9160;299579
BA;29;05800;Camamu;29233;1192;30425
BA;29;05909;Campo Alegre de Lourdes;30635;36;30671
BA;29;06006;Campo Formoso;70570;807;71377
BA;29;06105;Canápolis;10225;0;10225
BA;29;06204;Canarana;23883;323;24206
BA;29;06303;Canavieiras;32300;383;32683
BA;29;06402;Candeal;7703;69;7772
BA;29;06501;Candeias;70427;1955;72382
BA;29;06600;Candiba;12872;144;13016
BA;29;06709;Cândido Sales;25171;76;25247
BA;29;06808;Cansanção;37346;93;37439
BA;29;06824;Canudos;16105;0;16105
BA;29;06857;Capela do Alto Alegre;10707;37;10744
BA;29;06873;Capim Grosso;31876;1359;33235
BA;29;06899;Caraíbas;9891;49;9940
BA;29;06907;Caravelas;20081;505;20586
BA;29;07004;Cardeal da Silva;8168;131;8299
BA;29;07103;Carinhanha;28723;146;28869
BA;29;07202;Casa Nova;71239;846;72085
BA;29;07301;Castro Alves;24552;160;24712
BA;29;07400;Catolândia;3430;4;3434
BA;29;07509;Catu;47162;1033;48195
BA;29;07558;Caturama;8803;38;8841
BA;29;07608;Central;16346;2;16348
BA;29;07707;Chorrochó;10518;61;10579
BA;29;07806;Cícero Dantas;30869;37;30906
BA;29;07905;Cipó;17071;159;17230
BA;29;08002;Coaraci;16942;409;17351
BA;29;08101;Cocos;19040;111;19151
BA;29;08200;Conceição da Feira;20393;407;20800
BA;29;08309;Conceição do Almeida;15732;62;15794
BA;29;08408;Conceição do Coité;65868;1957;67825
BA;29;08507;Conceição do Jacuípe;35179;129;35308
BA;29;08606;Conde;23115;536;23651
BA;29;08705;Condeúba;16925;128;17053
BA;29;08804;Contendas do Sincorá;4312;21;4333
BA;29;08903;Coração de Maria;26461;231;26692
BA;29;09000;Cordeiros;7519;27;7546
BA;29;09109;Coribe;13965;25;13990
BA;29;09208;Coronel João Sá;17002;54;17056
BA;29;09307;Correntina;31894;565;32459
BA;29;09406;Cotegipe;12979;84;13063
BA;29;09505;Cravolândia;4391;24;4415
BA;29;09604;Crisópolis;19595;134;19729
BA;29;09703;Cristópolis;13962;31;13993
BA;29;09802;Cruz das Almas;58770;1576;60346
BA;29;09901;Curaçá;33707;473;34180
BA;29;10008;Dário Meira;10811;6;10817
BA;29;10057;Dias d'Ávila;70120;1365;71485
BA;29;10107;Dom Basílio;11733;151;11884
BA;29;10206;Dom Macedo Costa;4378;29;4407
BA;29;10305;Elísio Medrado;7770;39;7809
BA;29;10404;Encruzilhada;19085;22;19107
BA;29;10503;Entre Rios;37020;1078;38098
BA;29;10602;Esplanada;31593;963;32556
BA;29;10701;Euclides da Cunha;61092;364;61456
BA;29;10727;Eunápolis;108751;4958;113709
BA;29;10750;Fátima;17851;45;17896
BA;29;10776;Feira da Mata;5624;7;5631
BA;29;10800;Feira de Santana;599509;16770;616279
BA;29;10859;Filadélfia;17883;14;17897
BA;29;10909;Firmino Alves;4856;17;4873
BA;29;11006;Floresta Azul;10960;95;11055
BA;29;11105;Formosa do Rio Preto;25855;44;25899
BA;29;11204;Gandu;31784;394;32178
BA;29;11253;Gavião;4333;27;4360
BA;29;11303;Gentio do Ouro;10832;52;10884
BA;29;11402;Glória;15449;75;15524
BA;29;11501;Gongogi;5441;108;5549
BA;29;11600;Governador Mangabeira;20387;218;20605
BA;29;11659;Guajeru;8031;19;8050
BA;29;11709;Guanambi;86443;1374;87817
BA;29;11808;Guaratinga;18707;342;19049
BA;29;11857;Heliópolis;12295;14;12309
BA;29;11907;Iaçu;23948;659;24607
BA;29;12004;Ibiassucê;10372;57;10429
BA;29;12103;Ibicaraí;21537;128;21665
BA;29;12202;Ibicoara;20480;305;20785
BA;29;12301;Ibicuí;13928;6;13934
BA;29;12400;Ibipeba;16409;194;16603
BA;29;12509;Ibipitanga;13779;84;13863
BA;29;12608;Ibiquera;3724;1;3725
BA;29;12707;Ibirapitanga;24294;1047;25341
BA;29;12806;Ibirapuã;8775;121;8896
BA;29;12905;Ibirataia;18449;343;18792
BA;29;13002;Ibitiara;14602;32;14634
BA;29;13101;Ibititá;16697;272;16969
BA;29;13200;Ibotirama;25904;405;26309
BA;29;13309;Ichu;6180;10;6190
BA;29;13408;Igaporã;15527;0;15527
BA;29;13457;Igrapiúna;13109;42;13151
BA;29;13507;Iguaí;21321;37;21358
BA;29;13606;Ilhéus;173026;5677;178703
BA;29;13705;Inhambupe;33493;297;33790
BA;29;13804;Ipecaetá;13631;78;13709
BA;29;13903;Ipiaú;39429;1277;40706
BA;29;14000;Ipirá;55993;880;56873
BA;29;14109;Ipupiara;9923;12;9935
BA;29;14208;Irajuba;6083;18;6101
BA;29;14307;Iramaia;10734;18;10752
BA;29;14406;Iraquara;23265;614;23879
BA;29;14505;Irará;27558;485;28043
BA;29;14604;Irecê;72761;1746;74507
BA;29;14653;Itabela;27408;757;28165
BA;29;14703;Itaberaba;63192;1881;65073
BA;29;14802;Itabuna;180525;6183;186708
BA;29;14901;Itacaré;26513;1212;27725
BA;29;15007;Itaeté;13429;43;13472
BA;29;15106;Itagi;13725;78;13803
BA;29;15205;Itagibá;15066;244;15310
BA;29;15304;Itagimirim;6202;145;6347
BA;29;15353;Itaguaçu da Bahia;12265;46;12311
BA;29;15403;Itaju do Colônia;6001;36;6037
BA;29;15502;Itajuípe;18340;441;18781
BA;29;15601;Itamaraju;58609;994;59603
BA;29;15700;Itamari;7037;14;7051
BA;29;15809;Itambé;24363;31;24394
BA;29;15908;Itanagra;5819;95;5914
BA;29;16005;Itanhém;17410;403;17813
BA;29;16104;Itaparica;19674;115;19789
BA;29;16203;Itapé;10340;1;10341
BA;29;16302;Itapebi;8933;241;9174
BA;29;16401;Itapetinga;62985;2912;65897
BA;29;16500;Itapicuru;31433;246;31679
BA;29;16609;Itapitanga;10218;61;10279
BA;29;16708;Itaquara;8058;95;8153
BA;29;16807;Itarantim;17022;30;17052
BA;29;16856;Itatim;15686;51;15737
BA;29;16906;Itiruçu;10908;91;10999
BA;29;17003;Itiúba;33816;56;33872
BA;29;17102;Itororó;16387;230;16617
BA;29;17201;Ituaçu;17719;195;17914
BA;29;17300;Ituberá;21307;606;21913
BA;29;17334;Iuiu;11068;50;11118
BA;29;17359;Jaborandi;9267;5;9272
BA;29;17409;Jacaraci;14387;49;14436
BA;29;17508;Jacobina;80381;2209;82590
BA;29;17607;Jaguaquara;44831;1133;45964
BA;29;17706;Jaguarari;32594;109;32703
BA;29;17805;Jaguaripe;17380;279;17659
BA;29;17904;Jandaíra;9160;125;9285
BA;29;18001;Jequié;155491;3321;158812
BA;29;18100;Jeremoabo;37467;159;37626
BA;29;18209;Jiquiriçá;13603;26;13629
BA;29;18308;Jitaúna;14333;22;14355
BA;29;18357;João Dourado;24690;164;24854
BA;29;18407;Juazeiro;229781;6035;235816
BA;29;18456;Jucuruçu;9599;56;9655
BA;29;18506;Jussara;16273;81;16354
BA;29;18555;Jussari;5845;43;5888
BA;29;18605;Jussiape;7358;21;7379
BA;29;18704;Lafaiete Coutinho;4041;34;4075
BA;29;18753;Lagoa Real;14099;6;14105
BA;29;18803;Laje;20684;368;21052
BA;29;18902;Lajedão;3767;78;3845
BA;29;19009;Lajedinho;3515;12;3527
BA;29;19058;Lajedo do Tabocal;7482;12;7494
BA;29;19108;Lamarão;8716;30;8746
BA;29;19157;Lapão;24943;796;25739
BA;29;19207;Lauro de Freitas;194814;8520;203334
BA;29;19306;Lençóis;10723;51;10774
BA;29;19405;Licínio de Almeida;11768;66;11834
BA;29;19504;Livramento de Nossa Senhora;43130;781;43911
BA;29;19553;Luís Eduardo Magalhães;104064;3845;107909
BA;29;19603;Macajuba;10434;26;10460
BA;29;19702;Macarani;21063;536;21599
BA;29;19801;Macaúbas;40913;946;41859
BA;29;19900;Macururé;7221;35;7256
BA;29;19926;Madre de Deus;18049;455;18504
BA;29;19959;Maetinga;6931;42;6973
BA;29;20007;Maiquinique;8570;161;8731
BA;29;20106;Mairi;17462;212;17674
BA;29;20205;Malhada;15275;123;15398
BA;29;20304;Malhada de Pedras;8626;44;8670
BA;29;20403;Manoel Vitorino;13859;1;13860
BA;29;20452;Mansidão;13919;0;13919
BA;29;20502;Maracás;26871;749;27620
BA;29;20601;Maragogipe;35573;286;35859
BA;29;20700;Maraú;24360;220;24580
BA;29;20809;Marcionílio Souza;9263;4;9267
BA;29;20908;Mascote;13460;84;13544
BA;29;21005;Mata de São João;41818;748;42566
BA;29;21054;Matina;10278;52;10330
BA;29;21104;Medeiros Neto;22177;17;22194
BA;29;21203;Miguel Calmon;24321;340;24661
BA;29;21302;Milagres;11051;20;11071
BA;29;21401;Mirangaba;15327;407;15734
BA;29;21450;Mirante;10187;0;10187
BA;29;21500;Monte Santo;47680;100;47780
BA;29;21609;Morpará;7915;67;7982
BA;29;21708;Morro do Chapéu;32920;674;33594
BA;29;21807;Mortugaba;11061;82;11143
BA;29;21906;Mucugê;12104;33;12137
BA;29;22003;Mucuri;36975;1000;37975
BA;29;22052;Mulungu do Morro;12971;181;13152
BA;29;22102;Mundo Novo;16998;301;17299
BA;29;22201;Muniz Ferreira;7102;100;7202
BA;29;22250;Muquém do São Francisco;10349;94;10443
BA;29;22300;Muritiba;28416;291;28707
BA;29;22409;Mutuípe;19675;362;20037
BA;29;22508;Nazaré;26294;755;27049
BA;29;22607;Nilo Peçanha;11966;86;12052
BA;29;22656;Nordestina;18368;34;18402
BA;29;22706;Nova Canaã;13546;169;13715
BA;29;22730;Nova Fátima;7857;110;7967
BA;29;22755;Nova Ibiá;6410;91;6501
BA;29;22805;Nova Itarana;7592;188;7780
BA;29;22854;Nova Redenção;7531;7;7538
BA;29;22904;Nova Soure;24222;14;24236
BA;29;23001;Nova Viçosa;38956;553;39509
BA;29;23035;Novo Horizonte;11157;5;11162
BA;29;23050;Novo Triunfo;10625;35;10660
BA;29;23100;Olindina;22614;19;22633
BA;29;23209;Oliveira dos Brejinhos;20589;126;20715
BA;29;23308;Ouriçangas;7671;45;7716
BA;29;23357;Ourolândia;19147;96;19243
BA;29;23407;Palmas de Monte Alto;19964;114;20078
BA;29;23506;Palmeiras;10223;116;10339
BA;29;23605;Paramirim;20026;321;20347
BA;29;23704;Paratinga;29212;40;29252
BA;29;23803;Paripiranga;26539;65;26604
BA;29;23902;Pau Brasil;9261;109;9370
BA;29;24009;Paulo Afonso;110818;2052;112870
BA;29;24058;Pé de Serra;13205;38;13243
BA;29;24108;Pedrão;6191;44;6235
BA;29;24207;Pedro Alexandre;13877;77;13954
BA;29;24306;Piatã;19751;335;20086
BA;29;24405;Pilão Arcado;35250;107;35357
BA;29;24504;Pindaí;14660;71;14731
BA;29;24603;Pindobaçu;19051;32;19083
BA;29;24652;Pintadas;10323;2;10325
BA;29;24678;Piraí do Norte;10906;68;10974
BA;29;24702;Piripá;9119;33;9152
BA;29;24801;Piritiba;17274;292;17566
BA;29;24900;Planaltino;7911;111;8022
BA;29;25006;Planalto;23094;41;23135
BA;29;25105;Poções;48049;244;48293
BA;29;25204;Pojuca;31289;840;32129
BA;29;25253;Ponto Novo;17935;3;17938
BA;29;25303;Porto Seguro;160151;7804;167955
BA;29;25402;Potiraguá;10260;14;10274
BA;29;25501;Prado;34421;582;35003
BA;29;25600;Presidente Dutra;15051;79;15130
BA;29;25709;Presidente Jânio Quadros;12554;67;12621
BA;29;25758;Presidente Tancredo Neves;27309;417;27726
BA;29;25808;Queimadas;25686;292;25978
BA;29;25907;Quijingue;25242;30;25272
BA;29;25931;Quixabeira;9408;53;9461
BA;29;25956;Rafael Jambeiro;19223;439;19662
BA;29;26004;Remanso;40098;488;40586
BA;29;26103;Retirolândia;13594;57;13651
BA;29;26202;Riachão das Neves;21626;16;21642
BA;29;26301;Riachão do Jacuípe;32943;443;33386
BA;29;26400;Riacho de Santana;30565;146;30711
BA;29;26509;Ribeira do Amparo;13822;19;13841
BA;29;26608;Ribeira do Pombal;52681;1329;54010
BA;29;26657;Ribeirão do Largo;9698;42;9740
BA;29;26707;Rio de Contas;13124;60;13184
BA;29;26806;Rio do Antônio;13124;22;13146
BA;29;26905;Rio do Pires;10476;21;10497
BA;29;27002;Rio Real;35320;42;35362
BA;29;27101;Rodelas;10270;38;10308
BA;29;27200;Ruy Barbosa;28103;179;28282
BA;29;27309;Salinas da Margarida;14853;134;14987
BA;29;27408;Salvador;2344242;73763;2418005
BA;29;27507;Santa Bárbara;20704;248;20952
BA;29;27606;Santa Brígida;14857;108;14965
BA;29;27705;Santa Cruz Cabrália;28614;571;29185
BA;29;27804;Santa Cruz da Vitória;4667;14;4681
BA;29;27903;Santa Inês;10248;52;10300
BA;29;28000;Santaluz;37497;337;37834
BA;29;28059;Santa Luzia;13712;57;13769
BA;29;28109;Santa Maria da Vitória;37773;831;38604
BA;29;28208;Santana;24530;225;24755
BA;29;28307;Santanópolis;8625;91;8716
BA;29;28406;Santa Rita de Cássia;27373;17;27390
BA;29;28505;Santa Terezinha;10343;98;10441
BA;29;28604;Santo Amaro;55073;939;56012
BA;29;28703;Santo Antônio de Jesus;100150;2905;103055
BA;29;28802;Santo Estêvão;50093;2181;52274
BA;29;28901;São Desidério;32175;653;32828
BA;29;28950;São Domingos;8382;44;8426
BA;29;29008;São Félix;10941;85;11026
BA;29;29057;São Félix do Coribe;15000;194;15194
BA;29;29107;São Felipe;19896;387;20283
BA;29;29206;São Francisco do Conde;37266;466;37732
BA;29;29255;São Gabriel;18165;435;18600
BA;29;29305;São Gonçalo dos Campos;38571;942;39513
BA;29;29354;São José da Vitória;5309;6;5315
BA;29;29370;São José do Jacuípe;10057;130;10187
BA;29;29404;São Miguel das Matas;10324;10;10334
BA;29;29503;São Sebastião do Passé;40753;205;40958
BA;29;29602;Sapeaçu;17808;155;17963
BA;29;29701;Sátiro Dias;15892;116;16008
BA;29;29750;Saubara;11411;27;11438
BA;29;29800;Saúde;10456;22;10478
BA;29;29909;Seabra;45297;863;46160
BA;29;30006;Sebastião Laranjeiras;9359;1;9360
BA;29;30105;Senhor do Bonfim;73911;579;74490
BA;29;30154;Serra do Ramalho;34069;153;34222
BA;29;30204;Sento Sé;36958;1200;38158
BA;29;30303;Serra Dourada;16994;72;17066
BA;29;30402;Serra Preta;17940;56;17996
BA;29;30501;Serrinha;79018;1417;80435
BA;29;30600;Serrolândia;13244;91;13335
BA;29;30709;Simões Filho;108788;5653;114441
BA;29;30758;Sítio do Mato;13394;14;13408
BA;29;30766;Sítio do Quinto;14756;17;14773
BA;29;30774;Sobradinho;24375;1100;25475
BA;29;30808;Souto Soares;17041;17;17058
BA;29;30907;Tabocas do Brejo Velho;11937;42;11979
BA;29;31004;Tanhaçu;20900;106;21006
BA;29;31053;Tanque Novo;16536;622;17158
BA;29;31103;Tanquinho;7501;216;7717
BA;29;31202;Taperoá;17469;575;18044
BA;29;31301;Tapiramutá;15702;116;15818
BA;29;31350;Teixeira de Freitas;140049;5174;145223
BA;29;31400;Teodoro Sampaio;6789;321;7110
BA;29;31509;Teofilândia;20950;226;21176
BA;29;31608;Teolândia;15197;135;15332
BA;29;31707;Terra Nova;10633;165;10798
BA;29;31806;Tremedal;16021;275;16296
BA;29;31905;Tucano;47424;1314;48738
BA;29;32002;Uauá;24524;141;24665
BA;29;32101;Ubaíra;18361;265;18626
BA;29;32200;Ubaitaba;17437;173;17610
BA;29;32309;Ubatã;15409;702;16111
BA;29;32408;Uibaí;13331;101;13432
BA;29;32457;Umburanas;13424;218;13642
BA;29;32507;Una;17929;202;18131
BA;29;32606;Urandi;15279;76;15355
BA;29;32705;Uruçuca;21118;302;21420
BA;29;32804;Utinga;16210;67;16277
BA;29;32903;Valença;83272;2383;85655
BA;29;33000;Valente;24069;293;24362
BA;29;33059;Várzea da Roça;13771;26;13797
BA;29;33109;Várzea do Poço;7939;162;8101
BA;29;33158;Várzea Nova;13307;70;13377
BA;29;33174;Varzedo;9913;0;9913
BA;29;33208;Vera Cruz;41793;784;42577
BA;29;33257;Vereda;5921;82;6003
BA;29;33307;Vitória da Conquista;357458;13410;370868
BA;29;33406;Wagner;9423;80;9503
BA;29;33455;Wanderley;12941;27;12968
BA;29;33505;Wenceslau Guimarães;24343;131;24474
BA;29;33604;Xique-Xique;44324;433;44757
MG;31;00104;Abadia dos Dourados;6197;75;6272
MG;31;00203;Abaeté;22489;186;22675
MG;31;00302;Abre Campo;13822;105;13927
MG;31;00401;Acaiaca;3850;59;3909
MG;31;00500;Açucena;8937;6;8943
MG;31;00609;Água Boa;12588;1;12589
MG;31;00708;Água Comprida;2089;19;2108
MG;31;00807;Aguanil;4345;12;4357
MG;31;00906;Águas Formosas;18284;166;18450
MG;31;01003;Águas Vermelhas;14035;2;14037
MG;31;01102;Aimorés;24736;533;25269
MG;31;01201;Aiuruoca;6173;60;6233
MG;31;01300;Alagoa;2737;12;2749
MG;31;01409;Albertina;2902;43;2945
MG;31;01508;Além Paraíba;30144;573;30717
MG;31;01607;Alfenas;75700;3270;78970
MG;31;01631;Alfredo Vasconcelos;6834;97;6931
MG;31;01706;Almenara;40259;105;40364
MG;31;01805;Alpercata;6885;18;6903
MG;31;01904;Alpinópolis;18184;116;18300
MG;31;02001;Alterosa;13690;225;13915
MG;31;02050;Alto Caparaó;5586;209;5795
MG;31;02100;Alto Rio Doce;10802;89;10891
MG;31;02209;Alvarenga;3794;179;3973
MG;31;02308;Alvinópolis;14624;435;15059
MG;31;02407;Alvorada de Minas;4094;65;4159
MG;31;02506;Amparo do Serra;4527;14;4541
MG;31;02605;Andradas;39068;1480;40548
MG;31;02704;Cachoeira de Pajeú;9094;16;9110
MG;31;02803;Andrelândia;11729;198;11927
MG;31;02852;Angelândia;7718;0;7718
MG;31;02902;Antônio Carlos;10829;266;11095
MG;31;03009;Antônio Dias;9046;173;9219
MG;31;03108;Antônio Prado de Minas;1534;4;1538
MG;31;03207;Araçaí;2168;13;2181
MG;31;03306;Aracitaba;2038;11;2049
MG;31;03405;Araçuaí;33762;535;34297
MG;31;03504;Araguari;117290;518;117808
MG;31;03603;Arantina;2900;15;2915
MG;31;03702;Araponga;8040;8;8048
MG;31;03751;Araporã;8197;282;8479
MG;31;03801;Arapuá;2507;124;2631
MG;31;03900;Araújos;9081;118;9199
MG;31;04007;Araxá;109431;2260;111691
MG;31;04106;Arceburgo;8792;385;9177
MG;31;04205;Arcos;39519;1898;41417
MG;31;04304;Areado;13865;16;13881
MG;31;04403;Argirita;2591;97;2688
MG;31;04452;Aricanduva;4704;15;4719
MG;31;04502;Arinos;16611;661;17272
MG;31;04601;Astolfo Dutra;13604;534;14138
MG;31;04700;Ataléia;13719;17;13736
MG;31;04809;Augusto de Lima;4526;12;4538
MG;31;04908;Baependi;18171;195;18366
MG;31;05004;Baldim;7242;250;7492
MG;31;05103;Bambuí;22903;643;23546
MG;31;05202;Bandeira;4741;0;4741
MG;31;05301;Bandeira do Sul;5928;15;5943
MG;31;05400;Barão de Cocais;30464;314;30778
MG;31;05509;Barão de Monte Alto;4959;5;4964
MG;31;05608;Barbacena;120056;5261;125317
MG;31;05707;Barra Longa;5468;198;5666
MG;31;05905;Barroso;19429;651;20080
MG;31;06002;Bela Vista de Minas;9723;444;10167
MG;31;06101;Belmiro Braga;3081;163;3244
MG;31;06200;Belo Horizonte;2249116;66444;2315560
MG;31;06309;Belo Oriente;23810;118;23928
MG;31;06408;Belo Vale;8527;100;8627
MG;31;06507;Berilo;9792;34;9826
MG;31;06606;Bertópolis;4438;13;4451
MG;31;06655;Berizal;4201;0;4201
MG;31;06705;Betim;397775;14084;411859
MG;31;06804;Bias Fortes;3328;33;3361
MG;31;06903;Bicas;13853;125;13978
MG;31;07000;Biquinhas;2367;16;2383
MG;31;07109;Boa Esperança;39603;245;39848
MG;31;07208;Bocaina de Minas;5196;152;5348
MG;31;07307;Bocaiúva;47619;413;48032
MG;31;07406;Bom Despacho;49403;2334;51737
MG;31;07505;Bom Jardim de Minas;6756;27;6783
MG;31;07604;Bom Jesus da Penha;4405;69;4474
MG;31;07703;Bom Jesus do Amparo;5559;72;5631
MG;31;07802;Bom Jesus do Galho;14268;269;14537
MG;31;07901;Bom Repouso;12649;0;12649
MG;31;08008;Bom Sucesso;16638;513;17151
MG;31;08107;Bonfim;7379;55;7434
MG;31;08206;Bonfinópolis de Minas;5513;15;5528
MG;31;08255;Bonito de Minas;10138;66;10204
MG;31;08305;Borda da Mata;16786;618;17404
MG;31;08404;Botelhos;14751;77;14828
MG;31;08503;Botumirim;5783;7;5790
MG;31;08552;Brasilândia de Minas;14957;63;15020
MG;31;08602;Brasília de Minas;32019;6;32025
MG;31;08701;Brás Pires;4146;114;4260
MG;31;08800;Braúnas;4440;1;4441
MG;31;08909;Brazópolis;14118;128;14246
MG;31;09006;Brumadinho;37474;1441;38915
MG;31;09105;Bueno Brandão;10591;320;10911
MG;31;09204;Buenópolis;9121;29;9150
MG;31;09253;Bugre;4041;0;4041
MG;31;09303;Buritis;23230;804;24034
MG;31;09402;Buritizeiro;23598;312;23910
MG;31;09451;Cabeceira Grande;6494;133;6627
MG;31;09501;Cabo Verde;11159;251;11410
MG;31;09600;Cachoeira da Prata;3564;129;3693
MG;31;09709;Cachoeira de Minas;11451;433;11884
MG;31;09808;Cachoeira Dourada;2238;77;2315
MG;31;09907;Caetanópolis;11285;150;11435
MG;31;10004;Caeté;38255;521;38776
MG;31;10103;Caiana;5298;6;5304
MG;31;10202;Cajuri;4075;13;4088
MG;31;10301;Caldas;14107;110;14217
MG;31;10400;Camacho;2810;28;2838
MG;31;10509;Camanducaia;24983;1114;26097
MG;31;10608;Cambuí;28362;1174;29536
MG;31;10707;Cambuquira;11963;350;12313
MG;31;10806;Campanário;2852;71;2923
MG;31;10905;Campanha;15700;235;15935
MG;31;11002;Campestre;20646;50;20696
MG;31;11101;Campina Verde;17088;923;18011
MG;31;11150;Campo Azul;3714;0;3714
MG;31;11200;Campo Belo;50960;1317;52277
MG;31;11309;Campo do Meio;11371;6;11377
MG;31;11408;Campo Florido;8420;46;8466
MG;31;11507;Campos Altos;12882;97;12979
MG;31;11606;Campos Gerais;25890;215;26105
MG;31;11705;Canaã;4700;15;4715
MG;31;11804;Canápolis;10570;38;10608
MG;31;11903;Cana Verde;5198;74;5272
MG;31;12000;Candeias;13868;133;14001
MG;31;12059;Cantagalo;3943;31;3974
MG;31;12109;Caparaó;4849;199;5048
MG;31;12208;Capela Nova;4343;19;4362
MG;31;12307;Capelinha;39624;0;39624
MG;31;12406;Capetinga;6552;10;6562
MG;31;12505;Capim Branco;10416;247;10663
MG;31;12604;Capinópolis;13996;659;14655
MG;31;12653;Capitão Andrade;4573;12;4585
MG;31;12703;Capitão Enéas;13938;170;14108
MG;31;12802;Capitólio;10261;119;10380
MG;31;12901;Caputira;8707;229;8936
MG;31;13008;Caraí;19517;31;19548
MG;31;13107;Caranaíba;2908;25;2933
MG;31;13206;Carandaí;23345;467;23812
MG;31;13305;Carangola;30181;1059;31240
MG;31;13404;Caratinga;84177;3183;87360
MG;31;13503;Carbonita;8508;4;8512
MG;31;13602;Careaçu;6807;9;6816
MG;31;13701;Carlos Chagas;18613;2;18615
MG;31;13800;Carmésia;2578;27;2605
MG;31;13909;Carmo da Cachoeira;11473;74;11547
MG;31;14006;Carmo da Mata;10977;42;11019
MG;31;14105;Carmo de Minas;13733;64;13797
MG;31;14204;Carmo do Cajuru;23287;192;23479
MG;31;14303;Carmo do Paranaíba;27982;1029;29011
MG;31;14402;Carmo do Rio Claro;20879;75;20954
MG;31;14501;Carmópolis de Minas;17806;72;17878
MG;31;14550;Carneirinho;9390;32;9422
MG;31;14600;Carrancas;4023;26;4049
MG;31;14709;Carvalhópolis;3263;78;3341
MG;31;14808;Carvalhos;4361;61;4422
MG;31;14907;Casa Grande;2198;16;2214
MG;31;15003;Cascalho Rico;2707;5;2712
MG;31;15102;Cássia;17150;5;17155
MG;31;15201;Conceição da Barra de Minas;3515;45;3560
MG;31;15300;Cataguases;63170;3091;66261
MG;31;15359;Catas Altas;5292;181;5473
MG;31;15409;Catas Altas da Noruega;2966;144;3110
MG;31;15458;Catuji;7010;20;7030
MG;31;15474;Catuti;4736;3;4739
MG;31;15508;Caxambu;20550;506;21056
MG;31;15607;Cedro do Abaeté;1072;9;1081
MG;31;15706;Central de Minas;6088;83;6171
MG;31;15805;Centralina;10205;2;10207
MG;31;15904;Chácara;2954;121;3075
MG;31;16001;Chalé;6068;7;6075
MG;31;16100;Chapada do Norte;10337;0;10337
MG;31;16159;Chapada Gaúcha;12332;23;12355
MG;31;16209;Chiador;2800;0;2800
MG;31;16308;Cipotânea;5433;148;5581
MG;31;16407;Claraval;4658;0;4658
MG;31;16506;Claro dos Poções;7008;158;7166
MG;31;16605;Cláudio;29910;249;30159
MG;31;16704;Coimbra;6941;176;7117
MG;31;16803;Coluna;8163;0;8163
MG;31;16902;Comendador Gomes;2634;139;2773
MG;31;17009;Comercinho;6606;54;6660
MG;31;17108;Conceição da Aparecida;10306;65;10371
MG;31;17207;Conceição das Pedras;2753;19;2772
MG;31;17306;Conceição das Alagoas;28153;228;28381
MG;31;17405;Conceição de Ipanema;4399;10;4409
MG;31;17504;Conceição do Mato Dentro;23059;103;23162
MG;31;17603;Conceição do Pará;5269;146;5415
MG;31;17702;Conceição do Rio Verde;12528;13;12541
MG;31;17801;Conceição dos Ouros;10401;479;10880
MG;31;17836;Cônego Marinho;7212;25;7237
MG;31;17876;Confins;7077;273;7350
MG;31;17900;Congonhal;10791;292;11083
MG;31;18007;Congonhas;50787;2103;52890
MG;31;18106;Congonhas do Norte;4801;30;4831
MG;31;18205;Conquista;6673;21;6694
MG;31;18304;Conselheiro Lafaiete;126098;5523;131621
MG;31;18403;Conselheiro Pena;20048;776;20824
MG;31;18502;Consolação;1563;0;1563
MG;31;18601;Contagem;599236;22629;621865
MG;31;18700;Coqueiral;9012;11;9023
MG;31;18809;Coração de Jesus;24637;740;25377
MG;31;18908;Cordisburgo;7524;23;7547
MG;31;19005;Cordislândia;3079;121;3200
MG;31;19104;Corinto;22783;749;23532
MG;31;19203;Coroaci;10805;79;10884
MG;31;19302;Coromandel;28438;456;28894
MG;31;19401;Coronel Fabriciano;103040;1696;104736
MG;31;19500;Coronel Murta;8186;14;8200
MG;31;19609;Coronel Pacheco;2698;64;2762
MG;31;19708;Coronel Xavier Chaves;3386;100;3486
MG;31;19807;Córrego Danta;2896;64;2960
MG;31;19906;Córrego do Bom Jesus;4150;122;4272
MG;31;19955;Córrego Fundo;6010;123;6133
MG;31;20003;Córrego Novo;2843;32;2875
MG;31;20102;Couto de Magalhães de Minas;4158;87;4245
MG;31;20151;Crisólita;5182;83;5265
MG;31;20201;Cristais;11835;362;12197
MG;31;20300;Cristália;5111;10;5121
MG;31;20409;Cristiano Otoni;4507;160;4667
MG;31;20508;Cristina;10365;9;10374
MG;31;20607;Crucilândia;5362;72;5434
MG;31;20706;Cruzeiro da Fortaleza;3369;152;3521
MG;31;20805;Cruzília;15193;169;15362
MG;31;20839;Cuparaque;3895;88;3983
MG;31;20870;Curral de Dentro;7406;0;7406
MG;31;20904;Curvelo;77644;2708;80352
MG;31;21001;Datas;5418;47;5465
MG;31;21100;Delfim Moreira;7890;62;7952
MG;31;21209;Delfinópolis;8391;6;8397
MG;31;21258;Delta;10376;118;10494
MG;31;21308;Descoberto;4857;71;4928
MG;31;21407;Desterro de Entre Rios;7535;118;7653
MG;31;21506;Desterro do Melo;2989;5;2994
MG;31;21605;Diamantina;47239;463;47702
MG;31;21704;Diogo de Vasconcelos;3530;19;3549
MG;31;21803;Dionísio;6791;56;6847
MG;31;21902;Divinésia;4175;51;4226
MG;31;22009;Divino;20665;41;20706
MG;31;22108;Divino das Laranjeiras;4169;9;4178
MG;31;22207;Divinolândia de Minas;6470;46;6516
MG;31;22306;Divinópolis;223099;7992;231091
MG;31;22355;Divisa Alegre;6308;13;6321
MG;31;22405;Divisa Nova;5829;22;5851
MG;31;22454;Divisópolis;10213;0;10213
MG;31;22470;Dom Bosco;3690;7;3697
MG;31;22504;Dom Cavati;4875;29;4904
MG;31;22603;Dom Joaquim;4870;29;4899
MG;31;22702;Dom Silvério;5124;104;5228
MG;31;22801;Dom Viçoso;3095;0;3095
MG;31;22900;Dona Euzébia;5885;208;6093
MG;31;23007;Dores de Campos;9890;117;10007
MG;31;23106;Dores de Guanhães;5002;27;5029
MG;31;23205;Dores do Indaiá;12297;333;12630
MG;31;23304;Dores do Turvo;4982;5;4987
MG;31;23403;Doresópolis;1392;69;1461
MG;31;23502;Douradoquara;1818;11;1829
MG;31;23528;Durandé;7687;130;7817
MG;31;23601;Elói Mendes;25955;381;26336
MG;31;23700;Engenheiro Caldas;13609;13;13622
MG;31;23809;Engenheiro Navarro;6353;1;6354
MG;31;23858;Entre Folhas;4925;254;5179
MG;31;23908;Entre Rios de Minas;14107;639;14746
MG;31;24005;Ervália;19312;943;20255
MG;31;24104;Esmeraldas;83308;2286;85594
MG;31;24203;Espera Feliz;23763;339;24102
MG;31;24302;Espinosa;30358;85;30443
MG;31;24401;Espírito Santo do Dourado;6436;175;6611
MG;31;24500;Estiva;11354;148;11502
MG;31;24609;Estrela Dalva;2186;0;2186
MG;31;24708;Estrela do Indaiá;2762;10;2772
MG;31;24807;Estrela do Sul;6835;5;6840
MG;31;24906;Eugenópolis;10679;122;10801
MG;31;25002;Ewbank da Câmara;3806;69;3875
MG;31;25101;Extrema;52109;1373;53482
MG;31;25200;Fama;2479;99;2578
MG;31;25309;Faria Lemos;3077;111;3188
MG;31;25408;Felício dos Santos;5118;15;5133
MG;31;25507;São Gonçalo do Rio Preto;3001;31;3032
MG;31;25606;Felisburgo;6442;47;6489
MG;31;25705;Felixlândia;13954;24;13978
MG;31;25804;Fernandes Tourinho;2685;104;2789
MG;31;25903;Ferros;9484;106;9590
MG;31;25952;Fervedouro;10384;61;10445
MG;31;26000;Florestal;7744;301;8045
MG;31;26109;Formiga;65792;2456;68248
MG;31;26208;Formoso;7828;121;7949
MG;31;26307;Fortaleza de Minas;3464;13;3477
MG;31;26406;Fortuna de Minas;2973;120;3093
MG;31;26505;Francisco Badaró;7307;59;7366
MG;31;26604;Francisco Dumont;4501;2;4503
MG;31;26703;Francisco Sá;23383;93;23476
MG;31;26752;Franciscópolis;5012;22;5034
MG;31;26802;Frei Gaspar;5627;13;5640
MG;31;26901;Frei Inocêncio;8170;56;8226
MG;31;26950;Frei Lagonegro;3391;0;3391
MG;31;27008;Fronteira;14222;311;14533
MG;31;27057;Fronteira dos Vales;4322;23;4345
MG;31;27073;Fruta de Leite;4642;5;4647
MG;31;27107;Frutal;56961;1627;58588
MG;31;27206;Funilândia;4598;88;4686
MG;31;27305;Galiléia;6020;202;6222
MG;31;27339;Gameleiras;4787;6;4793
MG;31;27354;Glaucilândia;2901;27;2928
MG;31;27370;Goiabeira;2791;39;2830
MG;31;27388;Goianá;4014;39;4053
MG;31;27404;Gonçalves;4556;180;4736
MG;31;27503;Gonzaga;5211;19;5230
MG;31;27602;Gouveia;11104;227;11331
MG;31;27701;Governador Valadares;249652;7520;257172
MG;31;27800;Grão Mogol;13857;44;13901
MG;31;27909;Grupiara;1392;0;1392
MG;31;28006;Guanhães;31908;336;32244
MG;31;28105;Guapé;13613;159;13772
MG;31;28204;Guaraciaba;9731;22;9753
MG;31;28253;Guaraciama;5047;4;5051
MG;31;28303;Guaranésia;18714;436;19150
MG;31;28402;Guarani;7632;82;7714
MG;31;28501;Guarará;3031;118;3149
MG;31;28600;Guarda-Mor;6224;315;6539
MG;31;28709;Guaxupé;49459;1452;50911
MG;31;28808;Guidoval;7018;113;7131
MG;31;28907;Guimarânia;8305;173;8478
MG;31;29004;Guiricema;7709;69;7778
MG;31;29103;Gurinhatã;5142;50;5192
MG;31;29202;Heliodora;5908;226;6134
MG;31;29301;Iapu;12014;16;12030
MG;31;29400;Ibertioga;5117;81;5198
MG;31;29509;Ibiá;21998;231;22229
MG;31;29608;Ibiaí;6027;259;6286
MG;31;29657;Ibiracatu;5057;24;5081
MG;31;29707;Ibiraci;10930;18;10948
MG;31;29806;Ibirité;167071;3316;170387
MG;31;29905;Ibitiúra de Minas;3302;63;3365
MG;31;30002;Ibituruna;2585;113;2698
MG;31;30051;Icaraí de Minas;10652;25;10677
MG;31;30101;Igarapé;44080;1767;45847
MG;31;30200;Igaratinga;10777;53;10830
MG;31;30309;Iguatama;6785;41;6826
MG;31;30408;Ijaci;6730;273;7003
MG;31;30507;Ilicínea;12741;0;12741
MG;31;30556;Imbé de Minas;6942;44;6986
MG;31;30606;Inconfidentes;7176;125;7301
MG;31;30655;Indaiabira;6343;3;6346
MG;31;30705;Indianópolis;6150;21;6171
MG;31;30804;Ingaí;2488;92;2580
MG;31;30903;Inhapim;22221;471;22692
MG;31;31000;Inhaúma;6074;165;6239
MG;31;31109;Inimutaba;7078;293;7371
MG;31;31158;Ipaba;17054;82;17136
MG;31;31208;Ipanema;19255;267;19522
MG;31;31307;Ipatinga;222406;5325;227731
MG;31;31406;Ipiaçu;3731;44;3775
MG;31;31505;Ipuiúna;8762;373;9135
MG;31;31604;Iraí de Minas;6964;216;7180
MG;31;31703;Itabira;108713;4630;113343
MG;31;31802;Itabirinha;10319;43;10362
MG;31;31901;Itabirito;52227;1055;53282
MG;31;32008;Itacambira;4202;50;4252
MG;31;32107;Itacarambi;17048;160;17208
MG;31;32206;Itaguara;13595;251;13846
MG;31;32305;Itaipé;10454;9;10463
MG;31;32404;Itajubá;90493;2580;93073
MG;31;32503;Itamarandiba;32936;12;32948
MG;31;32602;Itamarati de Minas;3677;13;3690
MG;31;32701;Itambacuri;20777;265;21042
MG;31;32800;Itambé do Mato Dentro;2137;5;2142
MG;31;32909;Itamogi;10683;87;10770
MG;31;33006;Itamonte;14724;62;14786
MG;31;33105;Itanhandu;15141;95;15236
MG;31;33204;Itanhomi;11037;91;11128
MG;31;33303;Itaobim;19149;2;19151
MG;31;33402;Itapagipe;13105;585;13690
MG;31;33501;Itapecerica;20669;315;20984
MG;31;33600;Itapeva;12335;357;12692
MG;31;33709;Itatiaiuçu;12554;412;12966
MG;31;33758;Itaú de Minas;14371;35;14406
MG;31;33808;Itaúna;96119;1550;97669
MG;31;33907;Itaverava;5593;49;5642
MG;31;34004;Itinga;13673;72;13745
MG;31;34103;Itueta;5869;183;6052
MG;31;34202;Ituiutaba;97651;4566;102217
MG;31;34301;Itumirim;6523;112;6635
MG;31;34400;Iturama;37857;438;38295
MG;31;34509;Itutinga;4211;6;4217
MG;31;34608;Jaboticatubas;19536;870;20406
MG;31;34707;Jacinto;11018;24;11042
MG;31;34806;Jacuí;7380;115;7495
MG;31;34905;Jacutinga;25023;502;25525
MG;31;35001;Jaguaraçu;3039;53;3092
MG;31;35050;Jaíba;37413;247;37660
MG;31;35076;Jampruca;4296;0;4296
MG;31;35100;Janaúba;70120;579;70699
MG;31;35209;Januária;63674;1456;65130
MG;31;35308;Japaraíba;4502;6;4508
MG;31;35357;Japonvar;8002;125;8127
MG;31;35407;Jeceaba;5991;206;6197
MG;31;35456;Jenipapo de Minas;6061;39;6100
MG;31;35506;Jequeri;12354;65;12419
MG;31;35605;Jequitaí;6272;212;6484
MG;31;35704;Jequitibá;5763;120;5883
MG;31;35803;Jequitinhonha;23950;52;24002
MG;31;35902;Jesuânia;5135;3;5138
MG;31;36009;Joaíma;13883;5;13888
MG;31;36108;Joanésia;4300;29;4329
MG;31;36207;João Monlevade;77361;2826;80187
MG;31;36306;João Pinheiro;46737;64;46801
MG;31;36405;Joaquim Felício;3799;55;3854
MG;31;36504;Jordânia;10303;1;10304
MG;31;36520;José Gonçalves de Minas;3969;0;3969
MG;31;36553;José Raydan;4256;12;4268
MG;31;36579;Josenópolis;3627;3;3630
MG;31;36603;Nova União;5810;99;5909
MG;31;36652;Juatuba;29424;1292;30716
MG;31;36702;Juiz de Fora;524161;16595;540756
MG;31;36801;Juramento;3710;58;3768
MG;31;36900;Juruaia;10889;195;11084
MG;31;36959;Juvenília;5764;25;5789
MG;31;37007;Ladainha;14358;17;14375
MG;31;37106;Lagamar;6386;245;6631
MG;31;37205;Lagoa da Prata;49401;2011;51412
MG;31;37304;Lagoa dos Patos;3274;39;3313
MG;31;37403;Lagoa Dourada;12639;130;12769
MG;31;37502;Lagoa Formosa;18087;817;18904
MG;31;37536;Lagoa Grande;8515;454;8969
MG;31;37601;Lagoa Santa;72752;2393;75145
MG;31;37700;Lajinha;20613;222;20835
MG;31;37809;Lambari;20078;336;20414
MG;31;37908;Lamim;3168;16;3184
MG;31;38005;Laranjal;5744;219;5963
MG;31;38104;Lassance;7097;27;7124
MG;31;38203;Lavras;100417;4344;104761
MG;31;38302;Leandro Ferreira;3036;163;3199
MG;31;38351;Leme do Prado;4341;0;4341
MG;31;38401;Leopoldina;49282;1863;51145
MG;31;38500;Liberdade;4631;106;4737
MG;31;38609;Lima Duarte;16948;273;17221
MG;31;38625;Limeira do Oeste;8276;411;8687
MG;31;38658;Lontra;8709;81;8790
MG;31;38674;Luisburgo;6929;27;6956
MG;31;38682;Luislândia;6198;12;6210
MG;31;38708;Luminárias;5561;25;5586
MG;31;38807;Luz;17339;536;17875
MG;31;38906;Machacalis;6470;17;6487
MG;31;39003;Machado;37044;640;37684
MG;31;39102;Madre de Deus de Minas;5142;49;5191
MG;31;39201;Malacacheta;17516;0;17516
MG;31;39250;Mamonas;5981;16;5997
MG;31;39300;Manga;18771;115;18886
MG;31;39409;Manhuaçu;88853;3033;91886
MG;31;39508;Manhumirim;19625;985;20610
MG;31;39607;Mantena;26188;347;26535
MG;31;39706;Maravilhas;7297;36;7333
MG;31;39805;Mar de Espanha;12544;177;12721
MG;31;39904;Maria da Fé;14175;72;14247
MG;31;40001;Mariana;59947;1440;61387
MG;31;40100;Marilac;4126;98;4224
MG;31;40159;Mário Campos;15404;457;15861
MG;31;40209;Maripá de Minas;3321;66;3387
MG;31;40308;Marliéria;4385;207;4592
MG;31;40407;Marmelópolis;3184;16;3200
MG;31;40506;Martinho Campos;13590;413;14003
MG;31;40530;Martins Soares;8117;279;8396
MG;31;40555;Mata Verde;9104;9;9113
MG;31;40605;Materlândia;3935;28;3963
MG;31;40704;Mateus Leme;36637;1204;37841
MG;31;40803;Matias Barbosa;13532;589;14121
MG;31;40852;Matias Cardoso;8895;0;8895
MG;31;40902;Matipó;18363;189;18552
MG;31;41009;Mato Verde;12016;22;12038
MG;31;41108;Matozinhos;36111;1507;37618
MG;31;41207;Matutina;3803;11;3814
MG;31;41306;Medeiros;3814;86;3900
MG;31;41405;Medina;20131;25;20156
MG;31;41504;Mendes Pimentel;5590;16;5606
MG;31;41603;Mercês;10199;174;10373
MG;31;41702;Mesquita;5018;22;5040
MG;31;41801;Minas Novas;24389;16;24405
MG;31;41900;Minduri;3687;54;3741
MG;31;42007;Mirabela;13600;51;13651
MG;31;42106;Miradouro;8656;312;8968
MG;31;42205;Miraí;13066;567;13633
MG;31;42254;Miravânia;3985;0;3985
MG;31;42304;Moeda;4916;209;5125
MG;31;42403;Moema;7232;316;7548
MG;31;42502;Monjolos;2120;49;2169
MG;31;42601;Monsenhor Paulo;8016;324;8340
MG;31;42700;Montalvânia;13906;154;14060
MG;31;42809;Monte Alegre de Minas;19686;484;20170
MG;31;42908;Monte Azul;20273;55;20328
MG;31;43005;Monte Belo;12731;315;13046
MG;31;43104;Monte Carmelo;46923;766;47689
MG;31;43153;Monte Formoso;4381;0;4381
MG;31;43203;Monte Santo de Minas;20475;415;20890
MG;31;43302;Montes Claros;400556;13684;414240
MG;31;43401;Monte Sião;23815;274;24089
MG;31;43450;Montezuma;6886;2;6888
MG;31;43500;Morada Nova de Minas;8888;178;9066
MG;31;43609;Morro da Garça;2371;40;2411
MG;31;43708;Morro do Pilar;3133;0;3133
MG;31;43807;Munhoz;7327;124;7451
MG;31;43906;Muriaé;99440;4668;104108
MG;31;44003;Mutum;27617;18;27635
MG;31;44102;Muzambinho;21373;518;21891
MG;31;44201;Nacip Raydan;2453;6;2459
MG;31;44300;Nanuque;34633;405;35038
MG;31;44359;Naque;6195;108;6303
MG;31;44375;Natalândia;3454;66;3520
MG;31;44409;Natércia;4624;67;4691
MG;31;44508;Nazareno;8101;78;8179
MG;31;44607;Nepomuceno;24516;502;25018
MG;31;44656;Ninheira;10577;11;10588
MG;31;44672;Nova Belém;3151;0;3151
MG;31;44706;Nova Era;17074;364;17438
MG;31;44805;Nova Lima;108494;3203;111697
MG;31;44904;Nova Módica;3658;5;3663
MG;31;45000;Nova Ponte;14365;233;14598
MG;31;45059;Nova Porteirinha;6669;37;6706
MG;31;45109;Nova Resende;15878;509;16387
MG;31;45208;Nova Serrana;101176;4376;105552
MG;31;45307;Novo Cruzeiro;26959;16;26975
MG;31;45356;Novo Oriente de Minas;10224;51;10275
MG;31;45372;Novorizonte;4566;5;4571
MG;31;45406;Olaria;1910;35;1945
MG;31;45455;Olhos-d'Água;5385;0;5385
MG;31;45505;Olímpio Noronha;2555;0;2555
MG;31;45604;Oliveira;38876;386;39262
MG;31;45703;Oliveira Fortes;2002;25;2027
MG;31;45802;Onça de Pitangui;2922;47;2969
MG;31;45851;Oratórios;4917;0;4917
MG;31;45877;Orizânia;8346;91;8437
MG;31;45901;Ouro Branco;37074;1650;38724
MG;31;46008;Ouro Fino;31700;394;32094
MG;31;46107;Ouro Preto;72437;2387;74824
MG;31;46206;Ouro Verde de Minas;5694;63;5757
MG;31;46255;Padre Carvalho;5058;0;5058
MG;31;46305;Padre Paraíso;17262;72;17334
MG;31;46404;Paineiras;4160;64;4224
MG;31;46503;Pains;7999;143;8142
MG;31;46552;Pai Pedro;5540;11;5551
MG;31;46602;Paiva;1474;0;1474
MG;31;46701;Palma;5585;122;5707
MG;31;46750;Palmópolis;6241;60;6301
MG;31;46909;Papagaios;13807;113;13920
MG;31;47006;Paracatu;91436;2581;94017
MG;31;47105;Pará de Minas;94351;2788;97139
MG;31;47204;Paraguaçu;21554;169;21723
MG;31;47303;Paraisópolis;19967;478;20445
MG;31;47402;Paraopeba;23780;327;24107
MG;31;47501;Passabém;1595;5;1600
MG;31;47600;Passa Quatro;15481;34;15515
MG;31;47709;Passa Tempo;8402;71;8473
MG;31;47808;Passa Vinte;2229;4;2233
MG;31;47907;Passos;109161;2778;111939
MG;31;47956;Patis;4777;60;4837
MG;31;48004;Patos de Minas;152931;6304;159235
MG;31;48103;Patrocínio;87032;2794;89826
MG;31;48202;Patrocínio do Muriaé;5571;5;5576
MG;31;48301;Paula Cândido;8486;173;8659
MG;31;48400;Paulistas;4361;28;4389
MG;31;48509;Pavão;8047;0;8047
MG;31;48608;Peçanha;17417;29;17446
MG;31;48707;Pedra Azul;24396;14;24410
MG;31;48756;Pedra Bonita;7320;0;7320
MG;31;48806;Pedra do Anta;3151;160;3311
MG;31;48905;Pedra do Indaiá;4014;98;4112
MG;31;49002;Pedra Dourada;2710;47;2757
MG;31;49101;Pedralva;10724;36;10760
MG;31;49150;Pedras de Maria da Cruz;10366;86;10452
MG;31;49200;Pedrinópolis;3337;7;3344
MG;31;49309;Pedro Leopoldo;60633;1947;62580
MG;31;49408;Pedro Teixeira;1788;22;1810
MG;31;49507;Pequeri;3348;3;3351
MG;31;49606;Pequi;4136;19;4155
MG;31;49705;Perdigão;11789;479;12268
MG;31;49804;Perdizes;16758;393;17151
MG;31;49903;Perdões;20890;494;21384
MG;31;49952;Periquito;6537;16;6553
MG;31;50000;Pescador;3566;4;3570
MG;31;50109;Piau;2734;62;2796
MG;31;50158;Piedade de Caratinga;8200;329;8529
MG;31;50208;Piedade de Ponte Nova;3976;0;3976
MG;31;50307;Piedade do Rio Grande;4527;77;4604
MG;31;50406;Piedade dos Gerais;4958;61;5019
MG;31;50505;Pimenta;8220;343;8563
MG;31;50539;Pingo-d'Água;4546;160;4706
MG;31;50570;Pintópolis;7045;39;7084
MG;31;50604;Piracema;6584;116;6700
MG;31;50703;Pirajuba;5305;232;5537
MG;31;50802;Piranga;16451;567;17018
MG;31;50901;Piranguçu;5991;50;6041
MG;31;51008;Piranguinho;9019;101;9120
MG;31;51107;Pirapetinga;10969;108;11077
MG;31;51206;Pirapora;54159;1447;55606
MG;31;51305;Piraúba;11304;306;11610
MG;31;51404;Pitangui;26047;638;26685
MG;31;51503;Piumhi;35152;910;36062
MG;31;51602;Planura;10901;244;11145
MG;31;51701;Poço Fundo;16110;278;16388
MG;31;51800;Poços de Caldas;158481;5261;163742
MG;31;51909;Pocrane;8224;126;8350
MG;31;52006;Pompéu;30458;589;31047
MG;31;52105;Ponte Nova;57407;369;57776
MG;31;52131;Ponto Chique;3623;124;3747
MG;31;52170;Ponto dos Volantes;10853;30;10883
MG;31;52204;Porteirinha;37365;73;37438
MG;31;52303;Porto Firme;10568;1;10569
MG;31;52402;Poté;13647;19;13666
MG;31;52501;Pouso Alegre;146880;5332;152212
MG;31;52600;Pouso Alto;6487;79;6566
MG;31;52709;Prados;8914;134;9048
MG;31;52808;Prata;27178;1164;28342
MG;31;52907;Pratápolis;8324;82;8406
MG;31;53004;Pratinha;3548;11;3559
MG;31;53103;Presidente Bernardes;4825;25;4850
MG;31;53202;Presidente Juscelino;3349;116;3465
MG;31;53301;Presidente Kubitschek;3062;9;3071
MG;31;53400;Presidente Olegário;18019;746;18765
MG;31;53509;Alto Jequitibá;8355;42;8397
MG;31;53608;Prudente de Morais;11133;333;11466
MG;31;53707;Quartel Geral;3160;19;3179
MG;31;53806;Queluzito;1757;13;1770
MG;31;53905;Raposos;15672;607;16279
MG;31;54002;Raul Soares;23257;166;23423
MG;31;54101;Recreio;10925;82;11007
MG;31;54150;Reduto;7780;68;7848
MG;31;54200;Resende Costa;11058;172;11230
MG;31;54309;Resplendor;16706;520;17226
MG;31;54408;Ressaquinha;4536;12;4548
MG;31;54457;Riachinho;6714;149;6863
MG;31;54507;Riacho dos Machados;8756;0;8756
MG;31;54606;Ribeirão das Neves;316268;13526;329794
MG;31;54705;Ribeirão Vermelho;3909;171;4080
MG;31;54804;Rio Acima;9884;377;10261
MG;31;54903;Rio Casca;12696;93;12789
MG;31;55009;Rio Doce;2483;1;2484
MG;31;55108;Rio do Prado;4639;0;4639
MG;31;55207;Rio Espera;5423;6;5429
MG;31;55306;Rio Manso;5526;42;5568
MG;31;55405;Rio Novo;8324;194;8518
MG;31;55504;Rio Paranaíba;14086;446;14532
MG;31;55603;Rio Pardo de Minas;28159;112;28271
MG;31;55702;Rio Piracicaba;14146;485;14631
MG;31;55801;Rio Pomba;17127;316;17443
MG;31;55900;Rio Preto;5042;99;5141
MG;31;56007;Rio Vermelho;12515;123;12638
MG;31;56106;Ritápolis;4968;26;4994
MG;31;56205;Rochedo de Minas;2289;2;2291
MG;31;56304;Rodeiro;8570;94;8664
MG;31;56403;Romaria;3253;133;3386
MG;31;56452;Rosário da Limeira;4728;6;4734
MG;31;56502;Rubelita;5658;21;5679
MG;31;56601;Rubim;10297;1;10298
MG;31;56700;Sabará;125704;3668;129372
MG;31;56809;Sabinópolis;14163;77;14240
MG;31;56908;Sacramento;26148;522;26670
MG;31;57005;Salinas;40085;93;40178
MG;31;57104;Salto da Divisa;6097;13;6110
MG;31;57203;Santa Bárbara;29892;574;30466
MG;31;57252;Santa Bárbara do Leste;8077;381;8458
MG;31;57278;Santa Bárbara do Monte Verde;2959;136;3095
MG;31;57302;Santa Bárbara do Tugúrio;4191;17;4208
MG;31;57336;Santa Cruz de Minas;7890;219;8109
MG;31;57377;Santa Cruz de Salinas;3910;0;3910
MG;31;57401;Santa Cruz do Escalvado;4646;27;4673
MG;31;57500;Santa Efigênia de Minas;4028;11;4039
MG;31;57609;Santa Fé de Minas;3522;0;3522
MG;31;57658;Santa Helena de Minas;5902;36;5938
MG;31;57708;Santa Juliana;15679;55;15734
MG;31;57807;Santa Luzia;209705;9100;218805
MG;31;57906;Santa Margarida;16241;154;16395
MG;31;58003;Santa Maria de Itabira;10026;465;10491
MG;31;58102;Santa Maria do Salto;4743;12;4755
MG;31;58201;Santa Maria do Suaçuí;12722;66;12788
MG;31;58300;Santana da Vargem;6422;217;6639
MG;31;58409;Santana de Cataguases;3334;155;3489
MG;31;58508;Santana de Pirapama;7024;6;7030
MG;31;58607;Santana do Deserto;3617;130;3747
MG;31;58706;Santana do Garambéu;2126;11;2137
MG;31;58805;Santana do Jacaré;4201;13;4214
MG;31;58904;Santana do Manhuaçu;8916;71;8987
MG;31;58953;Santana do Paraíso;44079;721;44800
MG;31;59001;Santana do Riacho;5061;252;5313
MG;31;59100;Santana dos Montes;3465;4;3469
MG;31;59209;Santa Rita de Caldas;8342;118;8460
MG;31;59308;Santa Rita de Jacutinga;4558;197;4755
MG;31;59357;Santa Rita de Minas;6483;290;6773
MG;31;59407;Santa Rita de Ibitipoca;3300;1;3301
MG;31;59506;Santa Rita do Itueto;5761;65;5826
MG;31;59605;Santa Rita do Sapucaí;39043;1592;40635
MG;31;59704;Santa Rosa da Serra;3331;51;3382
MG;31;59803;Santa Vitória;20006;967;20973
MG;31;59902;Santo Antônio do Amparo;16724;561;17285
MG;31;60009;Santo Antônio do Aventureiro;3762;7;3769
MG;31;60108;Santo Antônio do Grama;4229;0;4229
MG;31;60207;Santo Antônio do Itambé;3896;19;3915
MG;31;60306;Santo Antônio do Jacinto;10327;0;10327
MG;31;60405;Santo Antônio do Monte;26131;1164;27295
MG;31;60454;Santo Antônio do Retiro;6629;0;6629
MG;31;60504;Santo Antônio do Rio Abaixo;1805;3;1808
MG;31;60603;Santo Hipólito;2671;46;2717
MG;31;60702;Santos Dumont;41336;1070;42406
MG;31;60801;São Bento Abade;4705;8;4713
MG;31;60900;São Brás do Suaçuí;3813;176;3989
MG;31;60959;São Domingos das Dores;5474;152;5626
MG;31;61007;São Domingos do Prata;16996;396;17392
MG;31;61056;São Félix de Minas;3165;35;3200
MG;31;61106;São Francisco;52586;176;52762
MG;31;61205;São Francisco de Paula;6137;50;6187
MG;31;61304;São Francisco de Sales;5600;132;5732
MG;31;61403;São Francisco do Glória;4724;76;4800
MG;31;61502;São Geraldo;10206;76;10282
MG;31;61601;São Geraldo da Piedade;3268;37;3305
MG;31;61650;São Geraldo do Baixio;3089;54;3143
MG;31;61700;São Gonçalo do Abaeté;7079;296;7375
MG;31;61809;São Gonçalo do Pará;11432;338;11770
MG;31;61908;São Gonçalo do Rio Abaixo;11379;471;11850
MG;31;62005;São Gonçalo do Sapucaí;23165;794;23959
MG;31;62104;São Gotardo;39471;1439;40910
MG;31;62203;São João Batista do Glória;7522;130;7652
MG;31;62252;São João da Lagoa;4799;23;4822
MG;31;62302;São João da Mata;2848;66;2914
MG;31;62401;São João da Ponte;23847;83;23930
MG;31;62450;São João das Missões;12919;105;13024
MG;31;62500;São João del Rei;87194;3031;90225
MG;31;62559;São João do Manhuaçu;11165;81;11246
MG;31;62575;São João do Manteninha;5294;37;5331
MG;31;62609;São João do Oriente;7002;68;7070
MG;31;62658;São João do Pacuí;3900;71;3971
MG;31;62708;São João do Paraíso;23660;250;23910
MG;31;62807;São João Evangelista;15120;195;15315
MG;31;62906;São João Nepomuceno;24638;927;25565
MG;31;62922;São Joaquim de Bicas;33100;1248;34348
MG;31;62948;São José da Barra;7630;163;7793
MG;31;62955;São José da Lapa;25567;448;26015
MG;31;63003;São José da Safira;3774;32;3806
MG;31;63102;São José da Varginha;4536;0;4536
MG;31;63201;São José do Alegre;4078;55;4133
MG;31;63300;São José do Divino;3461;3;3464
MG;31;63409;São José do Goiabal;5385;11;5396
MG;31;63508;São José do Jacuri;6124;73;6197
MG;31;63607;São José do Mantimento;2699;54;2753
MG;31;63706;São Lourenço;44255;543;44798
MG;31;63805;São Miguel do Anta;6304;30;6334
MG;31;63904;São Pedro da União;4813;72;4885
MG;31;64001;São Pedro dos Ferros;7129;37;7166
MG;31;64100;São Pedro do Suaçuí;5093;10;5103
MG;31;64209;São Romão;10292;23;10315
MG;31;64308;São Roque de Minas;6778;351;7129
MG;31;64407;São Sebastião da Bela Vista;6384;3;6387
MG;31;64431;São Sebastião da Vargem Alegre;3113;0;3113
MG;31;64472;São Sebastião do Anta;6148;46;6194
MG;31;64506;São Sebastião do Maranhão;10079;0;10079
MG;31;64605;São Sebastião do Oeste;8621;194;8815
MG;31;64704;São Sebastião do Paraíso;69771;2025;71796
MG;31;64803;São Sebastião do Rio Preto;1209;50;1259
MG;31;64902;São Sebastião do Rio Verde;2296;4;2300
MG;31;65008;São Tiago;10965;227;11192
MG;31;65107;São Tomás de Aquino;6600;140;6740
MG;31;65206;São Tomé das Letras;6687;217;6904
MG;31;65305;São Vicente de Minas;6683;121;6804
MG;31;65404;Sapucaí-Mirim;6068;243;6311
MG;31;65503;Sardoá;5053;51;5104
MG;31;65537;Sarzedo;36034;810;36844
MG;31;65552;Setubinha;9917;0;9917
MG;31;65560;Sem-Peixe;2432;1;2433
MG;31;65578;Senador Amaral;6156;50;6206
MG;31;65602;Senador Cortes;2231;9;2240
MG;31;65701;Senador Firmino;7705;11;7716
MG;31;65800;Senador José Bento;2045;23;2068
MG;31;65909;Senador Modestino Gonçalves;3915;93;4008
MG;31;66006;Senhora de Oliveira;5481;2;5483
MG;31;66105;Senhora do Porto;3064;3;3067
MG;31;66204;Senhora dos Remédios;10359;25;10384
MG;31;66303;Sericita;7345;0;7345
MG;31;66402;Seritinga;1790;29;1819
MG;31;66501;Serra Azul de Minas;3732;60;3792
MG;31;66600;Serra da Saudade;833;0;833
MG;31;66709;Serra dos Aimorés;6940;4;6944
MG;31;66808;Serra do Salitre;11505;296;11801
MG;31;66907;Serrania;7499;122;7621
MG;31;66956;Serranópolis de Minas;4399;0;4399
MG;31;67004;Serranos;1947;43;1990
MG;31;67103;Serro;21885;67;21952
MG;31;67202;Sete Lagoas;219490;7870;227360
MG;31;67301;Silveirânia;2230;93;2323
MG;31;67400;Silvianópolis;5915;264;6179
MG;31;67509;Simão Pereira;2849;98;2947
MG;31;67608;Simonésia;19425;325;19750
MG;31;67707;Sobrália;5044;93;5137
MG;31;67806;Soledade de Minas;5541;72;5613
MG;31;67905;Tabuleiro;3829;185;4014
MG;31;68002;Taiobeiras;32251;799;33050
MG;31;68051;Taparuba;3359;28;3387
MG;31;68101;Tapira;3956;162;4118
MG;31;68200;Tapiraí;1690;0;1690
MG;31;68309;Taquaraçu de Minas;4110;114;4224
MG;31;68408;Tarumirim;14380;329;14709
MG;31;68507;Teixeiras;12084;171;12255
MG;31;68606;Teófilo Otoni;135988;1430;137418
MG;31;68705;Timóteo;78830;2749;81579
MG;31;68804;Tiradentes;7418;326;7744
MG;31;68903;Tiros;7477;406;7883
MG;31;69000;Tocantins;15938;247;16185
MG;31;69059;Tocos do Moji;3718;108;3826
MG;31;69109;Toledo;7154;60;7214
MG;31;69208;Tombos;8500;109;8609
MG;31;69307;Três Corações;73582;1903;75485
MG;31;69356;Três Marias;27765;1130;28895
MG;31;69406;Três Pontas;52949;2310;55259
MG;31;69505;Tumiritinga;5745;141;5886
MG;31;69604;Tupaciguara;24428;1042;25470
MG;31;69703;Turmalina;19998;2;20000
MG;31;69802;Turvolândia;4867;68;4935
MG;31;69901;Ubá;101121;2244;103365
MG;31;70008;Ubaí;11669;39;11708
MG;31;70057;Ubaporanga;12396;621;13017
MG;31;70107;Uberaba;327679;10167;337846
MG;31;70206;Uberlândia;687148;26084;713232
MG;31;70305;Umburatiba;2673;11;2684
MG;31;70404;Unaí;83856;2763;86619
MG;31;70438;União de Minas;3716;112;3828
MG;31;70479;Uruana de Minas;3240;42;3282
MG;31;70503;Urucânia;10562;38;10600
MG;31;70529;Urucuia;17416;63;17479
MG;31;70578;Vargem Alegre;5636;144;5780
MG;31;70602;Vargem Bonita;2044;114;2158
MG;31;70651;Vargem Grande do Rio Pardo;4633;0;4633
MG;31;70701;Varginha;131417;5050;136467
MG;31;70750;Varjão de Minas;6752;217;6969
MG;31;70800;Várzea da Palma;33597;147;33744
MG;31;70909;Varzelândia;18567;273;18840
MG;31;71006;Vazante;19601;374;19975
MG;31;71030;Verdelândia;7631;41;7672
MG;31;71071;Veredinha;5181;0;5181
MG;31;71105;Veríssimo;3367;44;3411
MG;31;71154;Vermelho Novo;4845;54;4899
MG;31;71204;Vespasiano;125701;3545;129246
MG;31;71303;Viçosa;73304;3126;76430
MG;31;71402;Vieiras;3684;16;3700
MG;31;71501;Mathias Lobato;3037;1;3038
MG;31;71600;Virgem da Lapa;11783;21;11804
MG;31;71709;Virgínia;8728;180;8908
MG;31;71808;Virginópolis;10284;30;10314
MG;31;71907;Virgolândia;4478;74;4552
MG;31;72004;Visconde do Rio Branco;38058;1102;39160
MG;31;72103;Volta Grande;4438;5;4443
MG;31;72202;Wenceslau Braz;2326;30;2356
ES;32;00102;Afonso Cláudio;30522;162;30684
ES;32;00136;Águia Branca;9673;38;9711
ES;32;00169;Água Doce do Norte;11897;145;12042
ES;32;00201;Alegre;28387;790;29177
ES;32;00300;Alfredo Chaves;13619;217;13836
ES;32;00359;Alto Rio Novo;7407;27;7434
ES;32;00409;Anchieta;29552;432;29984
ES;32;00508;Apiacá;7143;80;7223
ES;32;00607;Aracruz;92011;2754;94765
ES;32;00706;Atílio Vivácqua;10348;192;10540
ES;32;00805;Baixo Guandu;29940;734;30674
ES;32;00904;Barra de São Francisco;40531;1967;42498
ES;32;01001;Boa Esperança;13441;167;13608
ES;32;01100;Bom Jesus do Norte;10154;100;10254
ES;32;01159;Brejetuba;12849;136;12985
ES;32;01209;Cachoeiro de Itapemirim;178838;6946;185784
ES;32;01308;Cariacica;340528;12982;353510
ES;32;01407;Castelo;35295;1635;36930
ES;32;01506;Colatina;116288;3704;119992
ES;32;01605;Conceição da Barra;26439;1019;27458
ES;32;01704;Conceição do Castelo;11743;194;11937
ES;32;01803;Divino de São Lourenço;5035;48;5083
ES;32;01902;Domingos Martins;34826;590;35416
ES;32;02009;Dores do Rio Preto;6473;123;6596
ES;32;02108;Ecoporanga;21584;408;21992
ES;32;02207;Fundão;17690;324;18014
ES;32;02256;Governador Lindenberg;10895;114;11009
ES;32;02306;Guaçuí;28944;414;29358
ES;32;02405;Guarapari;121104;3552;124656
ES;32;02454;Ibatiba;25197;183;25380
ES;32;02504;Ibiraçu;11224;489;11713
ES;32;02553;Ibitirama;9402;118;9520
ES;32;02603;Iconha;12031;295;12326
ES;32;02652;Irupi;13676;34;13710
ES;32;02702;Itaguaçu;13244;345;13589
ES;32;02801;Itapemirim;38981;851;39832
ES;32;02900;Itarana;10201;396;10597
ES;32;03007;Iúna;28219;371;28590
ES;32;03056;Jaguaré;28343;588;28931
ES;32;03106;Jerônimo Monteiro;11437;138;11575
ES;32;03130;João Neiva;13799;280;14079
ES;32;03163;Laranja da Terra;10902;192;11094
ES;32;03205;Linhares;162402;4384;166786
ES;32;03304;Mantenópolis;12559;211;12770
ES;32;03320;Marataízes;41030;899;41929
ES;32;03346;Marechal Floriano;17266;375;17641
ES;32;03353;Marilândia;11993;209;12202
ES;32;03403;Mimoso do Sul;24023;452;24475
ES;32;03502;Montanha;18846;54;18900
ES;32;03601;Mucurici;5428;38;5466
ES;32;03700;Muniz Freire;18068;85;18153
ES;32;03809;Muqui;13448;297;13745
ES;32;03908;Nova Venécia;48188;877;49065
ES;32;04005;Pancas;18710;183;18893
ES;32;04054;Pedro Canário;20922;600;21522
ES;32;04104;Pinheiros;23319;596;23915
ES;32;04203;Piúma;21477;823;22300
ES;32;04252;Ponto Belo;6443;54;6497
ES;32;04302;Presidente Kennedy;13429;267;13696
ES;32;04351;Rio Bananal;18723;550;19273
ES;32;04401;Rio Novo do Sul;10782;287;11069
ES;32;04500;Santa Leopoldina;12843;263;13106
ES;32;04559;Santa Maria de Jetibá;40765;871;41636
ES;32;04609;Santa Teresa;22287;521;22808
ES;32;04658;São Domingos do Norte;8517;72;8589
ES;32;04708;São Gabriel da Palha;31486;766;32252
ES;32;04807;São José do Calçado;10673;205;10878
ES;32;04906;São Mateus;120544;3206;123750
ES;32;04955;São Roque do Canaã;10613;273;10886
ES;32;05002;Serra;509790;10859;520649
ES;32;05010;Sooretama;26304;198;26502
ES;32;05036;Vargem Alta;19214;349;19563
ES;32;05069;Venda Nova do Imigrante;22765;1066;23831
ES;32;05101;Viana;71774;1649;73423
ES;32;05150;Vila Pavão;8811;100;8911
ES;32;05176;Vila Valério;13187;541;13728
ES;32;05200;Vila Velha;452531;15191;467722
ES;32;05309;Vitória;310173;12696;322869
RJ;33;00100;Angra dos Reis;164505;2913;167418
RJ;33;00159;Aperibé;10891;143;11034
RJ;33;00209;Araruama;124419;5250;129669
RJ;33;00225;Areal;11538;290;11828
RJ;33;00233;Armação dos Búzios;38117;1889;40006
RJ;33;00258;Arraial do Cabo;29698;1288;30986
RJ;33;00308;Barra do Piraí;89608;3275;92883
RJ;33;00407;Barra Mansa;162484;7415;169899
RJ;33;00456;Belford Roxo;478927;4160;483087
RJ;33;00506;Bom Jardim;27150;952;28102
RJ;33;00605;Bom Jesus do Itabapoana;33734;1439;35173
RJ;33;00704;Cabo Frio;213543;8444;221987
RJ;33;00803;Cachoeiras de Macacu;56207;736;56943
RJ;33;00902;Cambuci;14229;387;14616
RJ;33;00936;Carapebus;13323;524;13847
RJ;33;00951;Comendador Levy Gasparian;8384;357;8741
RJ;33;01009;Campos dos Goytacazes;470014;13537;483551
RJ;33;01108;Cantagalo;18490;900;19390
RJ;33;01157;Cardoso Moreira;12836;122;12958
RJ;33;01207;Carmo;16419;779;17198
RJ;33;01306;Casimiro de Abreu;44334;1776;46110
RJ;33;01405;Conceição de Macabu;20815;289;21104
RJ;33;01504;Cordeiro;19808;975;20783
RJ;33;01603;Duas Barras;10444;536;10980
RJ;33;01702;Duque de Caxias;776964;31188;808152
RJ;33;01801;Engenheiro Paulo de Frontin;11988;254;12242
RJ;33;01850;Guapimirim;49491;2205;51696
RJ;33;01876;Iguaba Grande;27293;627;27920
RJ;33;01900;Itaboraí;214949;9318;224267
RJ;33;02007;Itaguaí;114120;2721;116841
RJ;33;02056;Italva;14038;35;14073
RJ;33;02106;Itaocara;21792;1127;22919
RJ;33;02205;Itaperuna;96318;4723;101041
RJ;33;02254;Itatiaia;30779;129;30908
RJ;33;02270;Japeri;94464;1825;96289
RJ;33;02304;Laje do Muriaé;6986;350;7336
RJ;33;02403;Macaé;231550;14841;246391
RJ;33;02452;Macuco;5165;250;5415
RJ;33;02502;Magé;221206;6921;228127
RJ;33;02601;Mangaratiba;39322;1898;41220
RJ;33;02700;Maricá;181731;15569;197300
RJ;33;02809;Mendes;16910;592;17502
RJ;33;02858;Mesquita;165678;1450;167128
RJ;33;02908;Miguel Pereira;25348;1230;26578
RJ;33;03005;Miracema;26562;319;26881
RJ;33;03104;Natividade;14859;215;15074
RJ;33;03203;Nilópolis;145785;989;146774
RJ;33;03302;Niterói;459129;22629;481758
RJ;33;03401;Nova Friburgo;181222;8715;189937
RJ;33;03500;Nova Iguaçu;753097;32785;785882
RJ;33;03609;Paracambi;40618;757;41375
RJ;33;03708;Paraíba do Sul;40554;1509;42063
RJ;33;03807;Paraty;44545;327;44872
RJ;33;03856;Paty do Alferes;29107;512;29619
RJ;33;03906;Petrópolis;266540;12341;278881
RJ;33;03955;Pinheiral;23153;1145;24298
RJ;33;04003;Piraí;26158;1316;27474
RJ;33;04102;Porciúncula;17212;76;17288
RJ;33;04110;Porto Real;20308;65;20373
RJ;33;04128;Quatis;13085;597;13682
RJ;33;04144;Queimados;135227;5296;140523
RJ;33;04151;Quissamã;21524;869;22393
RJ;33;04201;Resende;129170;442;129612
RJ;33;04300;Rio Bonito;54089;2187;56276
RJ;33;04409;Rio Claro;16664;737;17401
RJ;33;04508;Rio das Flores;8695;259;8954
RJ;33;04524;Rio das Ostras;147060;9431;156491
RJ;33;04557;Rio de Janeiro;5858867;352556;6211423
RJ;33;04607;Santa Maria Madalena;9729;503;10232
RJ;33;04706;Santo Antônio de Pádua;40416;909;41325
RJ;33;04755;São Francisco de Itabapoana;44131;928;45059
RJ;33;04805;São Fidélis;38877;62;38939
RJ;33;04904;São Gonçalo;878378;18366;896744
RJ;33;05000;São João da Barra;36305;268;36573
RJ;33;05109;São João de Meriti;438707;2255;440962
RJ;33;05133;São José de Ubá;7070;0;7070
RJ;33;05158;São José do Vale do Rio Preto;21959;121;22080
RJ;33;05208;São Pedro da Aldeia;100936;3093;104029
RJ;33;05307;São Sebastião do Alto;7582;168;7750
RJ;33;05406;Sapucaia;17029;700;17729
RJ;33;05505;Saquarema;86787;2772;89559
RJ;33;05554;Seropédica;77292;3304;80596
RJ;33;05604;Silva Jardim;20378;974;21352
RJ;33;05703;Sumidouro;14497;709;15206
RJ;33;05752;Tanguá;30441;645;31086
RJ;33;05802;Teresópolis;158521;6602;165123
RJ;33;05901;Trajano de Moraes;9825;477;10302
RJ;33;06008;Três Rios;76681;1665;78346
RJ;33;06107;Valença;65231;2522;67753
RJ;33;06156;Varre-Sai;10173;34;10207
RJ;33;06206;Vassouras;33127;849;33976
RJ;33;06305;Volta Redonda;242044;19540;261584
SP;35;00105;Adamantina;34008;679;34687
SP;35;00204;Adolfo;4243;108;4351
SP;35;00303;Aguaí;31510;562;32072
SP;35;00402;Águas da Prata;7288;81;7369
SP;35;00501;Águas de Lindóia;16964;865;17829
SP;35;00550;Águas de Santa Bárbara;6871;306;7177
SP;35;00600;Águas de São Pedro;2599;181;2780
SP;35;00709;Agudos;37045;635;37680
SP;35;00758;Alambari;6072;69;6141
SP;35;00808;Alfredo Marcondes;4328;117;4445
SP;35;00907;Altair;3382;69;3451
SP;35;01004;Altinópolis;16343;475;16818
SP;35;01103;Alto Alegre;3841;0;3841
SP;35;01152;Alumínio;17072;229;17301
SP;35;01202;Álvares Florence;3865;50;3915
SP;35;01301;Álvares Machado;26057;1188;27245
SP;35;01400;Álvaro de Carvalho;4805;3;4808
SP;35;01509;Alvinlândia;2884;1;2885
SP;35;01608;Americana;232395;4852;237247
SP;35;01707;Américo Brasiliense;32353;666;33019
SP;35;01806;Américo de Campos;5867;3;5870
SP;35;01905;Amparo;65353;2655;68008
SP;35;02002;Analândia;4546;43;4589
SP;35;02101;Andradina;58461;1322;59783
SP;35;02200;Angatuba;23273;749;24022
SP;35;02309;Anhembi;5543;131;5674
SP;35;02408;Anhumas;3885;138;4023
SP;35;02507;Aparecida;31502;1067;32569
SP;35;02606;Aparecida d'Oeste;4028;58;4086
SP;35;02705;Apiaí;23114;1471;24585
SP;35;02754;Araçariguama;20470;1052;21522
SP;35;02804;Araçatuba;199435;689;200124
SP;35;02903;Araçoiaba da Serra;30912;1531;32443
SP;35;03000;Aramina;5406;14;5420
SP;35;03109;Arandu;6676;209;6885
SP;35;03158;Arapeí;2197;133;2330
SP;35;03208;Araraquara;233996;8232;242228
SP;35;03307;Araras;125759;5107;130866
SP;35;03356;Arco-Íris;2030;14;2044
SP;35;03406;Arealva;8035;95;8130
SP;35;03505;Areias;3441;136;3577
SP;35;03604;Areiópolis;9883;247;10130
SP;35;03703;Ariranha;7602;0;7602
SP;35;03802;Artur Nogueira;49758;1698;51456
SP;35;03901;Arujá;74802;11876;86678
SP;35;03950;Aspásia;1837;5;1842
SP;35;04008;Assis;98318;3091;101409
SP;35;04107;Atibaia;139225;19415;158640
SP;35;04206;Auriflama;13400;292;13692
SP;35;04305;Avaí;4341;142;4483
SP;35;04404;Avanhandava;11257;6;11263
SP;35;04503;Avaré;90770;2035;92805
SP;35;04602;Bady Bassitt;26638;622;27260
SP;35;04701;Balbinos;3855;32;3887
SP;35;04800;Bálsamo;9527;69;9596
SP;35;04909;Bananal;9466;503;9969
SP;35;05005;Barão de Antonina;3511;20;3531
SP;35;05104;Barbosa;5640;0;5640
SP;35;05203;Bariri;30932;663;31595
SP;35;05302;Barra Bonita;33430;916;34346
SP;35;05351;Barra do Chapéu;5009;153;5162
SP;35;05401;Barra do Turvo;6587;288;6875
SP;35;05500;Barretos;121687;798;122485
SP;35;05609;Barrinha;31519;573;32092
SP;35;05708;Barueri;302477;13996;316473
SP;35;05807;Bastos;21457;46;21503
SP;35;05906;Batatais;56470;1932;58402
SP;35;06003;Bauru;364560;14586;379146
SP;35;06102;Bebedouro;75375;998;76373
SP;35;06201;Bento de Abreu;2606;0;2606
SP;35;06300;Bernardino de Campos;11607;0;11607
SP;35;06359;Bertioga;57520;6668;64188
SP;35;06409;Bilac;7298;21;7319
SP;35;06508;Birigui;118084;895;118979
SP;35;06607;Biritiba Mirim;28448;1228;29676
SP;35;06706;Boa Esperança do Sul;12882;96;12978
SP;35;06805;Bocaina;11238;21;11259
SP;35;06904;Bofete;10214;246;10460
SP;35;07001;Boituva;58079;3002;61081
SP;35;07100;Bom Jesus dos Perdões;19782;2160;21942
SP;35;07159;Bom Sucesso de Itararé;3298;257;3555
SP;35;07209;Borá;868;39;907
SP;35;07308;Boracéia;4697;18;4715
SP;35;07407;Borborema;13913;313;14226
SP;35;07456;Borebi;2643;70;2713
SP;35;07506;Botucatu;136690;8465;145155
SP;35;07605;Bragança Paulista;163608;13203;176811
SP;35;07704;Braúna;5356;0;5356
SP;35;07753;Brejo Alegre;2563;2;2565
SP;35;07803;Brodowski;24165;1036;25201
SP;35;07902;Brotas;23461;437;23898
SP;35;08009;Buri;19349;901;20250
SP;35;08108;Buritama;17025;185;17210
SP;35;08207;Buritizal;4234;122;4356
SP;35;08306;Cabrália Paulista;4299;0;4299
SP;35;08405;Cabreúva;45309;1702;47011
SP;35;08504;Caçapava;92495;3707;96202
SP;35;08603;Cachoeira Paulista;30085;1479;31564
SP;35;08702;Caconde;17097;4;17101
SP;35;08801;Cafelândia;16627;27;16654
SP;35;08900;Caiabu;3697;15;3712
SP;35;09007;Caieiras;88651;6379;95030
SP;35;09106;Caiuá;5326;140;5466
SP;35;09205;Cajamar;86409;6280;92689
SP;35;09254;Cajati;27229;1286;28515
SP;35;09304;Cajobi;9133;0;9133
SP;35;09403;Cajuru;23118;712;23830
SP;35;09452;Campina do Monte Alegre;5870;84;5954
SP;35;09502;Campinas;1032753;105556;1138309
SP;35;09601;Campo Limpo Paulista;75120;2512;77632
SP;35;09700;Campos do Jordão;45821;1153;46974
SP;35;09809;Campos Novos Paulista;4888;0;4888
SP;35;09908;Cananéia;11870;419;12289
SP;35;09957;Canas;4864;67;4931
SP;35;10005;Cândido Mota;28626;823;29449
SP;35;10104;Cândido Rodrigues;2889;0;2889
SP;35;10153;Canitar;6025;258;6283
SP;35;10203;Capão Bonito;44247;2090;46337
SP;35;10302;Capela do Alto;22589;277;22866
SP;35;10401;Capivari;47314;2754;50068
SP;35;10500;Caraguatatuba;129794;5081;134875
SP;35;10609;Carapicuíba;340180;46941;387121
SP;35;10708;Cardoso;11276;69;11345
SP;35;10807;Casa Branca;27741;342;28083
SP;35;10906;Cássia dos Coqueiros;2673;126;2799
SP;35;11003;Castilho;19726;251;19977
SP;35;11102;Catanduva;112149;3636;115785
SP;35;11201;Catiguá;6995;8;7003
SP;35;11300;Cedral;12504;114;12618
SP;35;11409;Cerqueira César;20951;518;21469
SP;35;11508;Cerquilho;43477;1218;44695
SP;35;11607;Cesário Lange;18565;483;19048
SP;35;11706;Charqueada;14977;558;15535
SP;35;11904;Clementina;6982;0;6982
SP;35;12001;Colina;18395;92;18487
SP;35;12100;Colômbia;6534;95;6629
SP;35;12209;Conchal;27489;616;28105
SP;35;12308;Conchas;14894;338;15232
SP;35;12407;Cordeirópolis;23471;1043;24514
SP;35;12506;Coroados;5397;3;5400
SP;35;12605;Coronel Macedo;4196;84;4280
SP;35;12704;Corumbataí;3993;202;4195
SP;35;12803;Cosmópolis;57741;2032;59773
SP;35;12902;Cosmorama;8580;139;8719
SP;35;13009;Cotia;242577;31063;273640
SP;35;13108;Cravinhos;31228;2053;33281
SP;35;13207;Cristais Paulista;9035;237;9272
SP;35;13306;Cruzália;2063;45;2108
SP;35;13405;Cruzeiro;71799;3162;74961
SP;35;13504;Cubatão;105229;7242;112471
SP;35;13603;Cunha;21700;410;22110
SP;35;13702;Descalvado;30636;1120;31756
SP;35;13801;Diadema;359195;34042;393237
SP;35;13850;Dirce Reis;1603;17;1620
SP;35;13900;Divinolândia;11141;17;11158
SP;35;14007;Dobrada;8711;48;8759
SP;35;14106;Dois Córregos;23620;890;24510
SP;35;14205;Dolcinópolis;2190;17;2207
SP;35;14304;Dourado;7978;118;8096
SP;35;14403;Dracena;43877;1597;45474
SP;35;14502;Duartina;12134;194;12328
SP;35;14601;Dumont;9435;36;9471
SP;35;14700;Echaporã;6201;4;6205
SP;35;14809;Eldorado;12611;458;13069
SP;35;14908;Elias Fausto;16750;949;17699
SP;35;14924;Elisiário;3119;19;3138
SP;35;14957;Embaúba;2321;2;2323
SP;35;15004;Embu das Artes;234336;16384;250720
SP;35;15103;Embu-Guaçu;62245;4725;66970
SP;35;15129;Emilianópolis;2983;31;3014
SP;35;15152;Engenheiro Coelho;18955;611;19566
SP;35;15186;Espírito Santo do Pinhal;39310;506;39816
SP;35;15194;Espírito Santo do Turvo;4044;113;4157
SP;35;15202;Estrela d'Oeste;9414;3;9417
SP;35;15301;Estrela do Norte;2627;76;2703
SP;35;15350;Euclides da Cunha Paulista;7844;80;7924
SP;35;15400;Fartura;16641;0;16641
SP;35;15509;Fernandópolis;70727;459;71186
SP;35;15608;Fernando Prestes;5936;6;5942
SP;35;15657;Fernão;1656;0;1656
SP;35;15707;Ferraz de Vasconcelos;163235;15970;179205
SP;35;15806;Flora Rica;1487;0;1487
SP;35;15905;Floreal;2732;1;2733
SP;35;16002;Flórida Paulista;12670;288;12958
SP;35;16101;Florínea;3826;25;3851
SP;35;16200;Franca;340754;11783;352537
SP;35;16309;Francisco Morato;154955;10184;165139
SP;35;16408;Franco da Rocha;137822;7027;144849
SP;35;16507;Gabriel Monteiro;2763;0;2763
SP;35;16606;Gália;6298;82;6380
SP;35;16705;Garça;41985;125;42110
SP;35;16804;Gastão Vidigal;3229;23;3252
SP;35;16853;Gavião Peixoto;4585;117;4702
SP;35;16903;General Salgado;10272;40;10312
SP;35;17000;Getulina;10224;8;10232
SP;35;17109;Glicério;4136;2;4138
SP;35;17208;Guaiçara;11202;37;11239
SP;35;17307;Guaimbê;5510;2;5512
SP;35;17406;Guaíra;39170;103;39273
SP;35;17505;Guapiaçu;21611;100;21711
SP;35;17604;Guapiara;16795;276;17071
SP;35;17703;Guará;18570;36;18606
SP;35;17802;Guaraçaí;7280;161;7441
SP;35;17901;Guaraci;10246;104;10350
SP;35;18008;Guarani d'Oeste;1956;12;1968
SP;35;18107;Guarantã;6427;0;6427
SP;35;18206;Guararapes;30606;430;31036
SP;35;18305;Guararema;28257;2979;31236
SP;35;18404;Guaratinguetá;112979;5065;118044
SP;35;18503;Guareí;14618;395;15013
SP;35;18602;Guariba;37052;446;37498
SP;35;18701;Guarujá;261190;26444;287634
SP;35;18800;Guarulhos;1203402;88382;1291784
SP;35;18859;Guatapará;7068;252;7320
SP;35;18909;Guzolândia;4198;48;4246
SP;35;19006;Herculândia;8950;175;9125
SP;35;19055;Holambra;15008;111;15119
SP;35;19071;Hortolândia;224594;12047;236641
SP;35;19105;Iacanga;10008;429;10437
SP;35;19204;Iacri;5887;244;6131
SP;35;19253;Iaras;8006;4;8010
SP;35;19303;Ibaté;30986;1192;32178
SP;35;19402;Ibirá;11579;111;11690
SP;35;19501;Ibirarema;6187;198;6385
SP;35;19600;Ibitinga;58596;1441;60037
SP;35;19709;Ibiúna;69446;5511;74957
SP;35;19808;Icém;7673;146;7819
SP;35;19907;Iepê;7521;98;7619
SP;35;20004;Igaraçu do Tietê;22553;553;23106
SP;35;20103;Igarapava;25874;338;26212
SP;35;20202;Igaratá;9466;1139;10605
SP;35;20301;Iguape;27695;1420;29115
SP;35;20400;Ilhabela;33163;1771;34934
SP;35;20426;Ilha Comprida;12850;569;13419
SP;35;20442;Ilha Solteira;24666;883;25549
SP;35;20509;Indaiatuba;245360;10379;255739
SP;35;20608;Indiana;5084;6;5090
SP;35;20707;Indiaporã;3936;99;4035
SP;35;20806;Inúbia Paulista;3590;25;3615
SP;35;20905;Ipaussu;13398;314;13712
SP;35;21002;Iperó;35009;1450;36459
SP;35;21101;Ipeúna;6494;337;6831
SP;35;21150;Ipiguá;6629;132;6761
SP;35;21200;Iporanga;3961;85;4046
SP;35;21309;Ipuã;14350;104;14454
SP;35;21408;Iracemápolis;21813;154;21967
SP;35;21507;Irapuã;6763;104;6867
SP;35;21606;Irapuru;5924;14;5938
SP;35;21705;Itaberá;17089;894;17983
SP;35;21804;Itaí;24712;468;25180
SP;35;21903;Itajobi;16868;121;16989
SP;35;22000;Itaju;3522;96;3618
SP;35;22109;Itanhaém;107824;4652;112476
SP;35;22158;Itaoca;3369;52;3421
SP;35;22208;Itapecerica da Serra;141259;17263;158522
SP;35;22307;Itapetininga;150684;7106;157790
SP;35;22406;Itapeva;85484;4244;89728
SP;35;22505;Itapevi;218398;14115;232513
SP;35;22604;Itapira;69219;2803;72022
SP;35;22653;Itapirapuã Paulista;4304;2;4306
SP;35;22703;Itápolis;39204;289;39493
SP;35;22802;Itaporanga;13585;500;14085
SP;35;22901;Itapuí;13645;14;13659
SP;35;23008;Itapura;3849;130;3979
SP;35;23107;Itaquaquecetuba;315794;53481;369275
SP;35;23206;Itararé;42515;1923;44438
SP;35;23305;Itariri;14480;1048;15528
SP;35;23404;Itatiba;117252;5172;122424
SP;35;23503;Itatinga;18407;663;19070
SP;35;23602;Itirapina;15725;423;16148
SP;35;23701;Itirapuã;5762;17;5779
SP;35;23800;Itobi;8041;5;8046
SP;35;23909;Itu;149232;19008;168240
SP;35;24006;Itupeva;68067;2549;70616
SP;35;24105;Ituverava;37063;508;37571
SP;35;24204;Jaborandi;6208;13;6221
SP;35;24303;Jaboticabal;70420;1401;71821
SP;35;24402;Jacareí;225800;14475;240275
SP;35;24501;Jaci;7568;45;7613
SP;35;24600;Jacupiranga;15211;905;16116
SP;35;24709;Jaguariúna;57187;2160;59347
SP;35;24808;Jales;47661;1115;48776
SP;35;24907;Jambeiro;6221;176;6397
SP;35;25003;Jandira;109751;8294;118045
SP;35;25102;Jardinópolis;42684;2598;45282
SP;35;25201;Jarinu;35056;2479;37535
SP;35;25300;Jaú;127453;6044;133497
SP;35;25409;Jeriquara;3787;76;3863
SP;35;25508;Joanópolis;11514;1301;12815
SP;35;25607;João Ramalho;4085;286;4371
SP;35;25706;José Bonifácio;36049;584;36633
SP;35;25805;Júlio Mesquita;4254;0;4254
SP;35;25854;Jumirim;2991;68;3059
SP;35;25904;Jundiaí;400887;42229;443116
SP;35;26001;Junqueirópolis;20326;122;20448
SP;35;26100;Juquiá;16146;1008;17154
SP;35;26209;Juquitiba;25055;2349;27404
SP;35;26308;Lagoinha;5063;20;5083
SP;35;26407;Laranjal Paulista;25094;1167;26261
SP;35;26506;Lavínia;9583;106;9689
SP;35;26605;Lavrinhas;6940;231;7171
SP;35;26704;Leme;96716;1429;98145
SP;35;26803;Lençóis Paulista;65812;693;66505
SP;35;26902;Limeira;286311;5558;291869
SP;35;27009;Lindóia;6759;251;7010
SP;35;27108;Lins;74679;100;74779
SP;35;27207;Lorena;82257;2598;84855
SP;35;27256;Lourdes;1939;11;1950
SP;35;27306;Louveira;50316;1517;51833
SP;35;27405;Lucélia;19882;179;20061
SP;35;27504;Lucianópolis;2367;5;2372
SP;35;27603;Luís Antônio;11803;462;12265
SP;35;27702;Luiziânia;4701;0;4701
SP;35;27801;Lupércio;3981;0;3981
SP;35;27900;Lutécia;2560;106;2666
SP;35;28007;Macatuba;16516;313;16829
SP;35;28106;Macaubal;7350;131;7481
SP;35;28205;Macedônia;3963;0;3963
SP;35;28304;Magda;3137;28;3165
SP;35;28403;Mairinque;47868;2104;49972
SP;35;28502;Mairiporã;88304;5313;93617
SP;35;28601;Manduri;9822;49;9871
SP;35;28700;Marabá Paulista;4512;61;4573
SP;35;28809;Maracaí;12430;243;12673
SP;35;28858;Marapoama;3231;61;3292
SP;35;28908;Mariápolis;3468;45;3513
SP;35;29005;Marília;234773;2856;237629
SP;35;29104;Marinópolis;1853;7;1860
SP;35;29203;Martinópolis;24466;415;24881
SP;35;29302;Matão;77150;1883;79033
SP;35;29401;Mauá;387992;30269;418261
SP;35;29500;Mendonça;6004;155;6159
SP;35;29609;Meridiano;4562;10;4572
SP;35;29658;Mesópolis;1952;0;1952
SP;35;29708;Miguelópolis;19298;143;19441
SP;35;29807;Mineiros do Tietê;11192;38;11230
SP;35;29906;Miracatu;17130;1423;18553
SP;35;30003;Mira Estrela;3075;51;3126
SP;35;30102;Mirandópolis;27789;194;27983
SP;35;30201;Mirante do Paranapanema;15877;40;15917
SP;35;30300;Mirassol;61850;1487;63337
SP;35;30409;Mirassolândia;4640;29;4669
SP;35;30508;Mococa;66623;1058;67681
SP;35;30607;Mogi das Cruzes;407696;42259;449955
SP;35;30706;Mogi Guaçu;150588;3073;153661
SP;35;30805;Mogi Mirim;89648;2911;92559
SP;35;30904;Mombuca;3591;131;3722
SP;35;31001;Monções;1933;4;1937
SP;35;31100;Mongaguá;61380;571;61951
SP;35;31209;Monte Alegre do Sul;8011;616;8627
SP;35;31308;Monte Alto;47460;114;47574
SP;35;31407;Monte Aprazível;21746;534;22280
SP;35;31506;Monte Azul Paulista;18151;0;18151
SP;35;31605;Monte Castelo;4215;7;4222
SP;35;31704;Monteiro Lobato;3933;205;4138
SP;35;31803;Monte Mor;60222;4440;64662
SP;35;31902;Morro Agudo;27338;595;27933
SP;35;32009;Morungaba;13448;340;13788
SP;35;32058;Motuca;4019;15;4034
SP;35;32108;Murutinga do Sul;3628;109;3737
SP;35;32157;Nantes;2641;19;2660
SP;35;32207;Narandiba;5592;121;5713
SP;35;32306;Natividade da Serra;6920;79;6999
SP;35;32405;Nazaré Paulista;16569;1648;18217
SP;35;32504;Neves Paulista;9466;224;9690
SP;35;32603;Nhandeara;9824;28;9852
SP;35;32702;Nipoã;4693;57;4750
SP;35;32801;Nova Aliança;6562;131;6693
SP;35;32827;Nova Campina;8356;141;8497
SP;35;32843;Nova Canaã Paulista;2025;7;2032
SP;35;32868;Nova Castilho;1048;14;1062
SP;35;32900;Nova Europa;9080;231;9311
SP;35;33007;Nova Granada;19320;99;19419
SP;35;33106;Nova Guataporanga;2142;14;2156
SP;35;33205;Nova Independência;4600;9;4609
SP;35;33254;Novais;4407;5;4412
SP;35;33304;Nova Luzitânia;2837;0;2837
SP;35;33403;Nova Odessa;61120;899;62019
SP;35;33502;Novo Horizonte;37781;543;38324
SP;35;33601;Nuporanga;7362;29;7391
SP;35;33700;Ocauçu;4331;0;4331
SP;35;33809;Óleo;2484;25;2509
SP;35;33908;Olímpia;54348;727;55075
SP;35;34005;Onda Verde;4748;23;4771
SP;35;34104;Oriente;6077;8;6085
SP;35;34203;Orindiúva;6024;0;6024
SP;35;34302;Orlândia;37844;475;38319
SP;35;34401;Osasco;663747;79685;743432
SP;35;34500;Oscar Bressane;2470;0;2470
SP;35;34609;Osvaldo Cruz;30634;638;31272
SP;35;34708;Ourinhos;99824;4146;103970
SP;35;34757;Ouroeste;10215;79;10294
SP;35;34807;Ouro Verde;7686;93;7779
SP;35;34906;Pacaembu;14828;49;14877
SP;35;35002;Palestina;11375;101;11476
SP;35;35101;Palmares Paulista;9596;54;9650
SP;35;35200;Palmeira d'Oeste;8777;126;8903
SP;35;35309;Palmital;19246;348;19594
SP;35;35408;Panorama;14766;198;14964
SP;35;35507;Paraguaçu Paulista;40203;786;40989
SP;35;35606;Paraibuna;16266;1401;17667
SP;35;35705;Paraíso;6099;0;6099
SP;35;35804;Paranapanema;19094;301;19395
SP;35;35903;Paranapuã;4011;20;4031
SP;35;36000;Parapuã;10492;88;10580
SP;35;36109;Pardinho;7018;135;7153
SP;35;36208;Pariquera-Açu;18435;798;19233
SP;35;36257;Parisi;2889;3;2892
SP;35;36307;Patrocínio Paulista;14301;187;14488
SP;35;36406;Paulicéia;7837;118;7955
SP;35;36505;Paulínia;102265;8272;110537
SP;35;36570;Paulistânia;2072;18;2090
SP;35;36604;Paulo de Faria;7257;143;7400
SP;35;36703;Pederneiras;43696;1131;44827
SP;35;36802;Pedra Bela;6292;265;6557
SP;35;36901;Pedranópolis;2786;1;2787
SP;35;37008;Pedregulho;14993;532;15525
SP;35;37107;Pedreira;41780;1332;43112
SP;35;37156;Pedrinhas Paulista;2729;75;2804
SP;35;37206;Pedro de Toledo;10842;439;11281
SP;35;37305;Penápolis;61669;10;61679
SP;35;37404;Pereira Barreto;23574;521;24095
SP;35;37503;Pereiras;8406;253;8659
SP;35;37602;Peruíbe;64190;4154;68344
SP;35;37701;Piacatu;5518;1;5519
SP;35;37800;Piedade;50786;2184;52970
SP;35;37909;Pilar do Sul;26553;1058;27611
SP;35;38006;Pindamonhangaba;163038;2390;165428
SP;35;38105;Pindorama;14483;59;14542
SP;35;38204;Pinhalzinho;14623;596;15219
SP;35;38303;Piquerobi;3195;69;3264
SP;35;38501;Piquete;12050;440;12490
SP;35;38600;Piracaia;24206;1823;26029
SP;35;38709;Piracicaba;390531;32792;423323
SP;35;38808;Piraju;29436;0;29436
SP;35;38907;Pirajuí;21822;609;22431
SP;35;39004;Pirangi;10885;0;10885
SP;35;39103;Pirapora do Bom Jesus;17754;616;18370
SP;35;39202;Pirapozinho;24909;439;25348
SP;35;39301;Pirassununga;72173;1372;73545
SP;35;39400;Piratininga;15051;56;15107
SP;35;39509;Pitangueiras;33164;510;33674
SP;35;39608;Planalto;4339;50;4389
SP;35;39707;Platina;2943;87;3030
SP;35;39806;Poá;96743;7022;103765
SP;35;39905;Poloni;5592;0;5592
SP;35;40002;Pompéia;20175;21;20196
SP;35;40101;Pongaí;3395;0;3395
SP;35;40200;Pontal;37171;436;37607
SP;35;40259;Pontalinda;4068;59;4127
SP;35;40309;Pontes Gestal;2386;1;2387
SP;35;40408;Populina;4127;0;4127
SP;35;40507;Porangaba;10202;249;10451
SP;35;40606;Porto Feliz;52019;4478;56497
SP;35;40705;Porto Ferreira;51756;893;52649
SP;35;40754;Potim;20157;235;20392
SP;35;40804;Potirendaba;18395;101;18496
SP;35;40853;Pracinha;2574;4;2578
SP;35;40903;Pradópolis;16983;95;17078
SP;35;41000;Praia Grande;317319;32616;349935
SP;35;41059;Pratânia;5084;42;5126
SP;35;41109;Presidente Alves;3685;119;3804
SP;35;41208;Presidente Bernardes;14065;425;14490
SP;35;41307;Presidente Epitácio;38084;1421;39505
SP;35;41406;Presidente Prudente;213470;12198;225668
SP;35;41505;Presidente Venceslau;34934;267;35201
SP;35;41604;Promissão;35053;78;35131
SP;35;41653;Quadra;3254;151;3405
SP;35;41703;Quatá;12857;306;13163
SP;35;41802;Queiroz;3220;45;3265
SP;35;41901;Queluz;8899;260;9159
SP;35;42008;Quintana;6888;150;7038
SP;35;42107;Rafard;8703;262;8965
SP;35;42206;Rancharia;27814;774;28588
SP;35;42305;Redenção da Serra;4370;124;4494
SP;35;42404;Regente Feijó;20127;18;20145
SP;35;42503;Reginópolis;7545;117;7662
SP;35;42602;Registro;57115;2831;59946
SP;35;42701;Restinga;6146;258;6404
SP;35;42800;Ribeira;3099;33;3132
SP;35;42909;Ribeirão Bonito;10836;153;10989
SP;35;43006;Ribeirão Branco;17966;661;18627
SP;35;43105;Ribeirão Corrente;4577;31;4608
SP;35;43204;Ribeirão do Sul;4654;23;4677
SP;35;43238;Ribeirão dos Índios;2015;10;2025
SP;35;43253;Ribeirão Grande;7230;220;7450
SP;35;43303;Ribeirão Pires;105375;10184;115559
SP;35;43402;Ribeirão Preto;602035;96224;698259
SP;35;43501;Riversul;5556;43;5599
SP;35;43600;Rifaina;4003;46;4049
SP;35;43709;Rincão;9013;85;9098
SP;35;43808;Rinópolis;9168;91;9259
SP;35;43907;Rio Claro;188724;12694;201418
SP;35;44004;Rio das Pedras;30923;405;31328
SP;35;44103;Rio Grande da Serra;40300;3870;44170
SP;35;44202;Riolândia;10273;36;10309
SP;35;44251;Rosana;17223;217;17440
SP;35;44301;Roseira;10582;250;10832
SP;35;44400;Rubiácea;2686;14;2700
SP;35;44509;Rubinéia;3785;48;3833
SP;35;44608;Sabino;5111;1;5112
SP;35;44707;Sagres;2397;77;2474
SP;35;44806;Sales;6281;156;6437
SP;35;44905;Sales Oliveira;11363;48;11411
SP;35;45001;Salesópolis;14657;545;15202
SP;35;45100;Salmourão;4769;39;4808
SP;35;45159;Saltinho;7842;319;8161
SP;35;45209;Salto;120096;14223;134319
SP;35;45308;Salto de Pirapora;42221;1527;43748
SP;35;45407;Salto Grande;8962;88;9050
SP;35;45506;Sandovalina;3557;88;3645
SP;35;45605;Santa Adélia;14018;0;14018
SP;35;45704;Santa Albertina;6372;21;6393
SP;35;45803;Santa Bárbara d'Oeste;182119;1228;183347
SP;35;46009;Santa Branca;12990;985;13975
SP;35;46108;Santa Clara d'Oeste;2585;13;2598
SP;35;46207;Santa Cruz da Conceição;4238;39;4277
SP;35;46256;Santa Cruz da Esperança;2021;95;2116
SP;35;46306;Santa Cruz das Palmeiras;28001;863;28864
SP;35;46405;Santa Cruz do Rio Pardo;44415;2027;46442
SP;35;46504;Santa Ernestina;6118;0;6118
SP;35;46603;Santa Fé do Sul;34475;319;34794
SP;35;46702;Santa Gertrudes;22903;708;23611
SP;35;46801;Santa Isabel;44294;8880;53174
SP;35;46900;Santa Lúcia;6960;189;7149
SP;35;47007;Santa Maria da Serra;5080;163;5243
SP;35;47106;Santa Mercedes;2945;11;2956
SP;35;47205;Santana da Ponte Pensa;1670;0;1670
SP;35;47304;Santana de Parnaíba;131235;22870;154105
SP;35;47403;Santa Rita d'Oeste;2718;15;2733
SP;35;47502;Santa Rita do Passa Quatro;24205;628;24833
SP;35;47601;Santa Rosa de Viterbo;22902;509;23411
SP;35;47650;Santa Salete;1645;0;1645
SP;35;47700;Santo Anastácio;17651;312;17963
SP;35;47809;Santo André;670606;78313;748919
SP;35;47908;Santo Antônio da Alegria;6712;63;6775
SP;35;48005;Santo Antônio de Posse;22688;556;23244
SP;35;48054;Santo Antônio do Aracanguá;8355;24;8379
SP;35;48104;Santo Antônio do Jardim;6006;120;6126
SP;35;48203;Santo Antônio do Pinhal;7024;109;7133
SP;35;48302;Santo Expedito;2968;32;3000
SP;35;48401;Santópolis do Aguapeí;3896;3;3899
SP;35;48500;Santos;382804;35804;418608
SP;35;48609;São Bento do Sapucaí;11299;385;11684
SP;35;48708;São Bernardo do Campo;737073;73656;810729
SP;35;48807;São Caetano do Sul;160973;4682;165655
SP;35;48906;São Carlos;244639;10183;254822
SP;35;49003;São Francisco;2602;0;2602
SP;35;49102;São João da Boa Vista;90350;2185;92535
SP;35;49201;São João das Duas Pontes;2561;19;2580
SP;35;49250;São João de Iracema;1837;9;1846
SP;35;49300;São João do Pau d'Alho;2233;9;2242
SP;35;49409;São Joaquim da Barra;47810;748;48558
SP;35;49508;São José da Bela Vista;7425;201;7626
SP;35;49607;São José do Barreiro;3724;129;3853
SP;35;49706;São José do Rio Pardo;51308;896;52204
SP;35;49805;São José do Rio Preto;462773;17666;480439
SP;35;49904;São José dos Campos;669697;27731;697428
SP;35;49953;São Lourenço da Serra;15012;972;15984
SP;35;50001;São Luiz do Paraitinga;10217;120;10337
SP;35;50100;São Manuel;35897;1392;37289
SP;35;50209;São Miguel Arcanjo;31717;322;32039
SP;35;50308;São Paulo;9961714;1489531;11451245
SP;35;50407;São Pedro;35660;2596;38256
SP;35;50506;São Pedro do Turvo;7092;122;7214
SP;35;50605;São Roque;76629;2855;79484
SP;35;50704;São Sebastião;76614;4926;81540
SP;35;50803;São Sebastião da Grama;10402;39;10441
SP;35;50902;São Simão;12818;624;13442
SP;35;51009;São Vicente;303072;26772;329844
SP;35;51108;Sarapuí;9995;374;10369
SP;35;51207;Sarutaiá;3704;0;3704
SP;35;51306;Sebastianópolis do Sul;3016;114;3130
SP;35;51405;Serra Azul;12442;304;12746
SP;35;51504;Serrana;42063;1846;43909
SP;35;51603;Serra Negra;28667;1227;29894
SP;35;51702;Sertãozinho;125093;1794;126887
SP;35;51801;Sete Barras;12218;512;12730
SP;35;51900;Severínia;14575;1;14576
SP;35;52007;Silveiras;5871;315;6186
SP;35;52106;Socorro;38612;1510;40122
SP;35;52205;Sorocaba;639959;83615;723574
SP;35;52304;Sud Mennucci;7170;185;7355
SP;35;52403;Sumaré;258669;20877;279546
SP;35;52502;Suzano;280656;26708;307364
SP;35;52551;Suzanápolis;3331;34;3365
SP;35;52601;Tabapuã;11323;0;11323
SP;35;52700;Tabatinga;14375;394;14769
SP;35;52809;Taboão da Serra;246983;26559;273542
SP;35;52908;Taciba;6128;132;6260
SP;35;53005;Taguaí;12415;254;12669
SP;35;53104;Taiaçu;5677;0;5677
SP;35;53203;Taiúva;6546;2;6548
SP;35;53302;Tambaú;21249;186;21435
SP;35;53401;Tanabi;24553;712;25265
SP;35;53500;Tapiraí;7589;407;7996
SP;35;53609;Tapiratiba;11742;74;11816
SP;35;53658;Taquaral;2617;2;2619
SP;35;53708;Taquaritinga;51879;381;52260
SP;35;53807;Taquarituba;23917;433;24350
SP;35;53856;Taquarivaí;6604;272;6876
SP;35;53906;Tarabai;6471;65;6536
SP;35;53955;Tarumã;14520;362;14882
SP;35;54003;Tatuí;120567;3375;123942
SP;35;54102;Taubaté;304417;6322;310739
SP;35;54201;Tejupá;4127;0;4127
SP;35;54300;Teodoro Sampaio;21886;287;22173
SP;35;54409;Terra Roxa;7904;0;7904
SP;35;54508;Tietê;36643;1020;37663
SP;35;54607;Timburi;2461;3;2464
SP;35;54656;Torre de Pedra;2010;36;2046
SP;35;54706;Torrinha;9282;53;9335
SP;35;54755;Trabiju;1674;8;1682
SP;35;54805;Tremembé;50432;741;51173
SP;35;54904;Três Fronteiras;6744;60;6804
SP;35;54953;Tuiuti;6384;394;6778
SP;35;55000;Tupã;60985;2943;63928
SP;35;55109;Tupi Paulista;15774;80;15854
SP;35;55208;Turiúba;1815;3;1818
SP;35;55307;Turmalina;1647;22;1669
SP;35;55356;Ubarana;5270;95;5365
SP;35;55406;Ubatuba;89107;3873;92980
SP;35;55505;Ubirajara;5132;0;5132
SP;35;55604;Uchoa;10294;100;10394
SP;35;55703;União Paulista;1581;22;1603
SP;35;55802;Urânia;8763;70;8833
SP;35;55901;Uru;1387;0;1387
SP;35;56008;Urupês;13636;108;13744
SP;35;56107;Valentim Gentil;13886;212;14098
SP;35;56206;Valinhos;122540;3785;126325
SP;35;56305;Valparaíso;24218;23;24241
SP;35;56354;Vargem;9952;560;10512
SP;35;56404;Vargem Grande do Sul;39845;288;40133
SP;35;56453;Vargem Grande Paulista;46231;4102;50333
SP;35;56503;Várzea Paulista;111308;4463;115771
SP;35;56602;Vera Cruz;10125;51;10176
SP;35;56701;Vinhedo;73979;2684;76663
SP;35;56800;Viradouro;17413;1;17414
SP;35;56909;Vista Alegre do Alto;8109;0;8109
SP;35;56958;Vitória Brasil;1778;16;1794
SP;35;57006;Votorantim;112022;15901;127923
SP;35;57105;Votuporanga;95721;913;96634
SP;35;57154;Zacarias;2682;10;2692
SP;35;57204;Chavantes;12075;136;12211
SP;35;57303;Estiva Gerbi;11070;225;11295
PR;41;00103;Abatiá;7202;39;7241
PR;41;00202;Adrianópolis;6192;64;6256
PR;41;00301;Agudos do Sul;10215;18;10233
PR;41;00400;Almirante Tamandaré;112683;7142;119825
PR;41;00459;Altamira do Paraná;3510;80;3590
PR;41;00509;Altônia;18652;86;18738
PR;41;00608;Alto Paraná;13483;426;13909
PR;41;00707;Alto Piquiri;9656;71;9727
PR;41;00806;Alvorada do Sul;10315;11;10326
PR;41;00905;Amaporã;4740;22;4762
PR;41;01002;Ampére;19594;26;19620
PR;41;01051;Anahy;2894;24;2918
PR;41;01101;Andirá;19831;47;19878
PR;41;01150;Ângulo;3002;233;3235
PR;41;01200;Antonina;17566;525;18091
PR;41;01309;Antônio Olinto;6860;158;7018
PR;41;01408;Apucarana;126578;3556;130134
PR;41;01507;Arapongas;117565;1573;119138
PR;41;01606;Arapoti;25589;188;25777
PR;41;01655;Arapuã;3515;12;3527
PR;41;01705;Araruna;13767;718;14485
PR;41;01804;Araucária;145610;6056;151666
PR;41;01853;Ariranha do Ivaí;2329;0;2329
PR;41;01903;Assaí;13304;493;13797
PR;41;02000;Assis Chateaubriand;35999;809;36808
PR;41;02109;Astorga;25010;465;25475
PR;41;02208;Atalaia;3972;8;3980
PR;41;02307;Balsa Nova;12813;582;13395
PR;41;02406;Bandeirantes;31102;171;31273
PR;41;02505;Barbosa Ferraz;10647;148;10795
PR;41;02604;Barracão;9635;124;9759
PR;41;02703;Barra do Jacaré;2781;33;2814
PR;41;02752;Bela Vista da Caroba;4031;0;4031
PR;41;02802;Bela Vista do Paraíso;14509;324;14833
PR;41;02901;Bituruna;15504;29;15533
PR;41;03008;Boa Esperança;4469;89;4558
PR;41;03024;Boa Esperança do Iguaçu;2455;0;2455
PR;41;03040;Boa Ventura de São Roque;6042;336;6378
PR;41;03057;Boa Vista da Aparecida;7861;63;7924
PR;41;03107;Bocaiúva do Sul;12853;428;13281
PR;41;03156;Bom Jesus do Sul;3976;4;3980
PR;41;03206;Bom Sucesso;6482;99;6581
PR;41;03222;Bom Sucesso do Sul;3134;68;3202
PR;41;03305;Borrazópolis;7713;22;7735
PR;41;03354;Braganey;4833;21;4854
PR;41;03370;Brasilândia do Sul;3664;44;3708
PR;41;03404;Cafeara;2627;0;2627
PR;41;03453;Cafelândia;18215;782;18997
PR;41;03479;Cafezal do Sul;4455;18;4473
PR;41;03503;Califórnia;8705;5;8710
PR;41;03602;Cambará;23110;100;23210
PR;41;03701;Cambé;104768;2440;107208
PR;41;03800;Cambira;9390;70;9460
PR;41;03909;Campina da Lagoa;15526;197;15723
PR;41;03958;Campina do Simão;3931;5;3936
PR;41;04006;Campina Grande do Sul;45805;1994;47799
PR;41;04055;Campo Bonito;4021;6;4027
PR;41;04105;Campo do Tenente;7433;75;7508
PR;41;04204;Campo Largo;130741;5586;136327
PR;41;04253;Campo Magro;29616;263;29879
PR;41;04303;Campo Mourão;94358;5074;99432
PR;41;04402;Cândido de Abreu;15167;77;15244
PR;41;04428;Candói;14943;30;14973
PR;41;04451;Cantagalo;10596;337;10933
PR;41;04501;Capanema;20210;271;20481
PR;41;04600;Capitão Leônidas Marques;13960;688;14648
PR;41;04659;Carambeí;22773;510;23283
PR;41;04709;Carlópolis;16769;136;16905
PR;41;04808;Cascavel;321818;26233;348051
PR;41;04907;Castro;70154;2890;73044
PR;41;05003;Catanduvas;10409;37;10446
PR;41;05102;Centenário do Sul;10784;48;10832
PR;41;05201;Cerro Azul;15785;349;16134
PR;41;05300;Céu Azul;11030;57;11087
PR;41;05409;Chopinzinho;20532;547;21079
PR;41;05508;Cianorte;73943;5584;79527
PR;41;05607;Cidade Gaúcha;11463;4;11467
PR;41;05706;Clevelândia;14620;450;15070
PR;41;05805;Colombo;219746;12310;232056
PR;41;05904;Colorado;22862;34;22896
PR;41;06001;Congonhinhas;8303;17;8320
PR;41;06100;Conselheiro Mairinck;3396;65;3461
PR;41;06209;Contenda;18324;804;19128
PR;41;06308;Corbélia;17369;101;17470
PR;41;06407;Cornélio Procópio;45119;87;45206
PR;41;06456;Coronel Domingos Soares;5415;234;5649
PR;41;06506;Coronel Vivida;22578;753;23331
PR;41;06555;Corumbataí do Sul;3693;67;3760
PR;41;06571;Cruzeiro do Iguaçu;4117;16;4133
PR;41;06605;Cruzeiro do Oeste;23723;108;23831
PR;41;06704;Cruzeiro do Sul;4492;2;4494
PR;41;06803;Cruz Machado;15835;143;15978
PR;41;06852;Cruzmaltina;2862;20;2882
PR;41;06902;Curitiba;1727757;45976;1773733
PR;41;07009;Curiúva;13008;639;13647
PR;41;07108;Diamante do Norte;5111;31;5142
PR;41;07124;Diamante do Sul;3140;31;3171
PR;41;07157;Diamante D'Oeste;4241;316;4557
PR;41;07207;Dois Vizinhos;44662;207;44869
PR;41;07256;Douradina;9140;21;9161
PR;41;07306;Doutor Camargo;6154;173;6327
PR;41;07405;Enéas Marques;5993;6;5999
PR;41;07504;Engenheiro Beltrão;12032;422;12454
PR;41;07520;Esperança Nova;1846;3;1849
PR;41;07538;Entre Rios do Oeste;4461;114;4575
PR;41;07546;Espigão Alto do Iguaçu;4726;71;4797
PR;41;07553;Farol;2983;56;3039
PR;41;07603;Faxinal;16282;107;16389
PR;41;07652;Fazenda Rio Grande;141373;7500;148873
PR;41;07702;Fênix;4425;67;4492
PR;41;07736;Fernandes Pinheiro;6182;73;6255
PR;41;07751;Figueira;8014;48;8062
PR;41;07801;Floraí;4686;106;4792
PR;41;07850;Flor da Serra do Sul;4314;50;4364
PR;41;07900;Floresta;10138;320;10458
PR;41;08007;Florestópolis;11041;405;11446
PR;41;08106;Flórida;2634;18;2652
PR;41;08205;Formosa do Oeste;7609;26;7635
PR;41;08304;Foz do Iguaçu;269312;16103;285415
PR;41;08320;Francisco Alves;7874;242;8116
PR;41;08403;Francisco Beltrão;95294;1372;96666
PR;41;08452;Foz do Jordão;4888;38;4926
PR;41;08502;General Carneiro;10846;216;11062
PR;41;08551;Godoy Moreira;2970;7;2977
PR;41;08601;Goioerê;27166;1271;28437
PR;41;08650;Goioxim;6560;6;6566
PR;41;08700;Grandes Rios;5625;16;5641
PR;41;08809;Guaíra;30071;2026;32097
PR;41;08908;Guairaçá;6453;91;6544
PR;41;08957;Guamiranga;7856;0;7856
PR;41;09005;Guapirama;4552;74;4626
PR;41;09104;Guaporema;2167;24;2191
PR;41;09203;Guaraci;4743;5;4748
PR;41;09302;Guaraniaçu;13681;54;13735
PR;41;09401;Guarapuava;176444;5649;182093
PR;41;09500;Guaraqueçaba;7214;216;7430
PR;41;09609;Guaratuba;39405;2657;42062
PR;41;09658;Honório Serpa;4941;0;4941
PR;41;09708;Ibaiti;28532;298;28830
PR;41;09757;Ibema;6218;0;6218
PR;41;09807;Ibiporã;49010;2593;51603
PR;41;09906;Icaraíma;8935;56;8991
PR;41;10003;Iguaraçu;4968;370;5338
PR;41;10052;Iguatu;2138;6;2144
PR;41;10078;Imbaú;13798;451;14249
PR;41;10102;Imbituva;29883;41;29924
PR;41;10201;Inácio Martins;9613;57;9670
PR;41;10300;Inajá;2519;17;2536
PR;41;10409;Indianópolis;4397;51;4448
PR;41;10508;Ipiranga;14078;64;14142
PR;41;10607;Iporã;15413;333;15746
PR;41;10656;Iracema do Oeste;2333;10;2343
PR;41;10706;Irati;58184;1066;59250
PR;41;10805;Iretama;10633;51;10684
PR;41;10904;Itaguajé;4465;16;4481
PR;41;10953;Itaipulândia;11009;476;11485
PR;41;11001;Itambaracá;5815;93;5908
PR;41;11100;Itambé;5917;194;6111
PR;41;11209;Itapejara d'Oeste;11799;545;12344
PR;41;11258;Itaperuçu;30794;423;31217
PR;41;11308;Itaúna do Sul;3545;27;3572
PR;41;11407;Ivaí;13151;78;13229
PR;41;11506;Ivaiporã;32396;324;32720
PR;41;11555;Ivaté;6735;96;6831
PR;41;11605;Ivatuba;2681;27;2708
PR;41;11704;Jaboti;5298;129;5427
PR;41;11803;Jacarezinho;40093;282;40375
PR;41;11902;Jaguapitã;14975;147;15122
PR;41;12009;Jaguariaíva;34998;143;35141
PR;41;12108;Jandaia do Sul;21403;5;21408
PR;41;12207;Janiópolis;5808;62;5870
PR;41;12306;Japira;4876;96;4972
PR;41;12405;Japurá;9000;144;9144
PR;41;12504;Jardim Alegre;11952;52;12004
PR;41;12603;Jardim Olinda;1328;15;1343
PR;41;12702;Jataizinho;11316;497;11813
PR;41;12751;Jesuítas;10479;27;10506
PR;41;12801;Joaquim Távora;11566;379;11945
PR;41;12900;Jundiaí do Sul;3250;83;3333
PR;41;12959;Juranda;7708;63;7771
PR;41;13007;Jussara;6575;115;6690
PR;41;13106;Kaloré;4579;3;4582
PR;41;13205;Lapa;44265;738;45003
PR;41;13254;Laranjal;5416;184;5600
PR;41;13304;Laranjeiras do Sul;31796;431;32227
PR;41;13403;Leópolis;3747;5;3752
PR;41;13429;Lidianópolis;3938;0;3938
PR;41;13452;Lindoeste;4900;275;5175
PR;41;13502;Loanda;22245;980;23225
PR;41;13601;Lobato;4591;10;4601
PR;41;13700;Londrina;529005;26932;555937
PR;41;13734;Luiziana;6346;344;6690
PR;41;13759;Lunardelli;4845;27;4872
PR;41;13809;Lupionópolis;4776;37;4813
PR;41;13908;Mallet;13252;176;13428
PR;41;14005;Mamborê;13080;372;13452
PR;41;14104;Mandaguaçu;30104;1353;31457
PR;41;14203;Mandaguari;34713;2003;36716
PR;41;14302;Mandirituba;26604;830;27434
PR;41;14351;Manfrinópolis;2770;0;2770
PR;41;14401;Mangueirinha;15880;723;16603
PR;41;14500;Manoel Ribas;13596;644;14240
PR;41;14609;Marechal Cândido Rondon;53664;2172;55836
PR;41;14708;Maria Helena;5805;60;5865
PR;41;14807;Marialva;40318;1533;41851
PR;41;14906;Marilândia do Sul;8677;0;8677
PR;41;15002;Marilena;7164;89;7253
PR;41;15101;Mariluz;9817;30;9847
PR;41;15200;Maringá;376530;33127;409657
PR;41;15309;Mariópolis;6214;157;6371
PR;41;15358;Maripá;6263;292;6555
PR;41;15408;Marmeleiro;15792;109;15901
PR;41;15457;Marquinho;4499;5;4504
PR;41;15507;Marumbi;4679;20;4699
PR;41;15606;Matelândia;18221;229;18450
PR;41;15705;Matinhos;36970;2289;39259
PR;41;15739;Mato Rico;3165;102;3267
PR;41;15754;Mauá da Serra;9055;328;9383
PR;41;15804;Medianeira;52020;2349;54369
PR;41;15853;Mercedes;5647;284;5931
PR;41;15903;Mirador;2238;0;2238
PR;41;16000;Miraselva;1928;38;1966
PR;41;16059;Missal;10451;613;11064
PR;41;16109;Moreira Sales;11020;155;11175
PR;41;16208;Morretes;17552;757;18309
PR;41;16307;Munhoz de Melo;3951;0;3951
PR;41;16406;Nossa Senhora das Graças;3657;12;3669
PR;41;16505;Nova Aliança do Ivaí;1312;11;1323
PR;41;16604;Nova América da Colina;3260;20;3280
PR;41;16703;Nova Aurora;13691;74;13765
PR;41;16802;Nova Cantu;6723;67;6790
PR;41;16901;Nova Esperança;25746;839;26585
PR;41;16950;Nova Esperança do Sudoeste;5586;11;5597
PR;41;17008;Nova Fátima;7210;15;7225
PR;41;17057;Nova Laranjeiras;12029;45;12074
PR;41;17107;Nova Londrina;12752;171;12923
PR;41;17206;Nova Olímpia;5827;6;5833
PR;41;17214;Nova Santa Bárbara;4167;17;4184
PR;41;17222;Nova Santa Rosa;8017;305;8322
PR;41;17255;Nova Prata do Iguaçu;12633;66;12699
PR;41;17271;Nova Tebas;6837;11;6848
PR;41;17297;Novo Itacolomi;3104;21;3125
PR;41;17305;Ortigueira;22066;2126;24192
PR;41;17404;Ourizona;3093;94;3187
PR;41;17453;Ouro Verde do Oeste;6439;346;6785
PR;41;17503;Paiçandu;43506;2456;45962
PR;41;17602;Palmas;47970;277;48247
PR;41;17701;Palmeira;31480;2375;33855
PR;41;17800;Palmital;12706;327;13033
PR;41;17909;Palotina;33564;1447;35011
PR;41;18006;Paraíso do Norte;13243;2;13245
PR;41;18105;Paranacity;9544;13;9557
PR;41;18204;Paranaguá;135641;10188;145829
PR;41;18303;Paranapoema;2388;10;2398
PR;41;18402;Paranavaí;88704;3246;91950
PR;41;18451;Pato Bragado;5600;133;5733
PR;41;18501;Pato Branco;88097;3739;91836
PR;41;18600;Paula Freitas;5577;89;5666
PR;41;18709;Paulo Frontin;6211;132;6343
PR;41;18808;Peabiru;12884;462;13346
PR;41;18857;Perobal;6901;288;7189
PR;41;18907;Pérola;11743;135;11878
PR;41;19004;Pérola d'Oeste;6221;0;6221
PR;41;19103;Piên;13606;49;13655
PR;41;19152;Pinhais;122765;4254;127019
PR;41;19202;Pinhalão;6537;29;6566
PR;41;19251;Pinhal de São Bento;2759;2;2761
PR;41;19301;Pinhão;29553;333;29886
PR;41;19400;Piraí do Sul;23540;109;23649
PR;41;19509;Piraquara;113669;5061;118730
PR;41;19608;Pitanga;31880;1687;33567
PR;41;19657;Pitangueiras;2948;98;3046
PR;41;19707;Planaltina do Paraná;4025;45;4070
PR;41;19806;Planalto;14369;5;14374
PR;41;19905;Ponta Grossa;339719;18648;358367
PR;41;19954;Pontal do Paraná;29011;1414;30425
PR;41;20002;Porecatu;11182;442;11624
PR;41;20101;Porto Amazonas;3969;129;4098
PR;41;20150;Porto Barreiro;3108;2;3110
PR;41;20200;Porto Rico;3042;140;3182
PR;41;20309;Porto Vitória;3516;46;3562
PR;41;20333;Prado Ferreira;3628;81;3709
PR;41;20358;Pranchita;5674;63;5737
PR;41;20408;Presidente Castelo Branco;4236;100;4336
PR;41;20507;Primeiro de Maio;9971;111;10082
PR;41;20606;Prudentópolis;49042;351;49393
PR;41;20655;Quarto Centenário;4179;22;4201
PR;41;20705;Quatiguá;7895;204;8099
PR;41;20804;Quatro Barras;23234;957;24191
PR;41;20853;Quatro Pontes;4185;295;4480
PR;41;20903;Quedas do Iguaçu;30069;669;30738
PR;41;21000;Querência do Norte;10335;350;10685
PR;41;21109;Quinta do Sol;4893;108;5001
PR;41;21208;Quitandinha;18126;272;18398
PR;41;21257;Ramilândia;4074;147;4221
PR;41;21307;Rancho Alegre;3509;3;3512
PR;41;21356;Rancho Alegre D'Oeste;2571;47;2618
PR;41;21406;Realeza;19242;5;19247
PR;41;21505;Rebouças;14430;84;14514
PR;41;21604;Renascença;6817;24;6841
PR;41;21703;Reserva;23118;1455;24573
PR;41;21752;Reserva do Iguaçu;6485;68;6553
PR;41;21802;Ribeirão Claro;12305;59;12364
PR;41;21901;Ribeirão do Pinhal;12668;392;13060
PR;41;22008;Rio Azul;13931;94;14025
PR;41;22107;Rio Bom;3120;77;3197
PR;41;22156;Rio Bonito do Iguaçu;13924;5;13929
PR;41;22172;Rio Branco do Ivaí;3771;37;3808
PR;41;22206;Rio Branco do Sul;37540;18;37558
PR;41;22305;Rio Negro;30840;484;31324
PR;41;22404;Rolândia;70670;1000;71670
PR;41;22503;Roncador;11088;163;11251
PR;41;22602;Rondon;8979;118;9097
PR;41;22651;Rosário do Ivaí;5392;43;5435
PR;41;22701;Sabáudia;8674;148;8822
PR;41;22800;Salgado Filho;4073;2;4075
PR;41;22909;Salto do Itararé;5165;27;5192
PR;41;23006;Salto do Lontra;15100;123;15223
PR;41;23105;Santa Amélia;3380;14;3394
PR;41;23204;Santa Cecília do Pavão;3341;24;3365
PR;41;23303;Santa Cruz de Monte Castelo;8344;269;8613
PR;41;23402;Santa Fé;11377;1;11378
PR;41;23501;Santa Helena;24998;494;25492
PR;41;23600;Santa Inês;1744;4;1748
PR;41;23709;Santa Isabel do Ivaí;8852;60;8912
PR;41;23808;Santa Izabel do Oeste;14061;9;14070
PR;41;23824;Santa Lúcia;3637;7;3644
PR;41;23857;Santa Maria do Oeste;9844;90;9934
PR;41;23907;Santa Mariana;10862;204;11066
PR;41;23956;Santa Mônica;3351;5;3356
PR;41;24004;Santana do Itararé;5508;6;5514
PR;41;24020;Santa Tereza do Oeste;12319;855;13174
PR;41;24053;Santa Terezinha de Itaipu;22904;1358;24262
PR;41;24103;Santo Antônio da Platina;43854;515;44369
PR;41;24202;Santo Antônio do Caiuá;2424;69;2493
PR;41;24301;Santo Antônio do Paraíso;2105;20;2125
PR;41;24400;Santo Antônio do Sudoeste;23110;563;23673
PR;41;24509;Santo Inácio;6168;13;6181
PR;41;24608;São Carlos do Ivaí;6549;38;6587
PR;41;24707;São Jerônimo da Serra;10816;14;10830
PR;41;24806;São João;11648;238;11886
PR;41;24905;São João do Caiuá;5481;105;5586
PR;41;25001;São João do Ivaí;10642;25;10667
PR;41;25100;São João do Triunfo;13596;130;13726
PR;41;25209;São Jorge d'Oeste;9337;41;9378
PR;41;25308;São Jorge do Ivaí;5128;40;5168
PR;41;25357;São Jorge do Patrocínio;6452;52;6504
PR;41;25407;São José da Boa Vista;6030;10;6040
PR;41;25456;São José das Palmeiras;3759;111;3870
PR;41;25506;São José dos Pinhais;310778;18444;329222
PR;41;25555;São Manoel do Paraná;2129;9;2138
PR;41;25605;São Mateus do Sul;41544;814;42358
PR;41;25704;São Miguel do Iguaçu;27847;1275;29122
PR;41;25753;São Pedro do Iguaçu;5350;434;5784
PR;41;25803;São Pedro do Ivaí;8687;3;8690
PR;41;25902;São Pedro do Paraná;2656;5;2661
PR;41;26009;São Sebastião da Amoreira;7999;64;8063
PR;41;26108;São Tomé;5113;119;5232
PR;41;26207;Sapopema;6564;131;6695
PR;41;26256;Sarandi;115701;2754;118455
PR;41;26272;Saudade do Iguaçu;6097;11;6108
PR;41;26306;Sengés;17175;95;17270
PR;41;26355;Serranópolis do Iguaçu;4829;178;5007
PR;41;26405;Sertaneja;5605;11;5616
PR;41;26504;Sertanópolis;15420;510;15930
PR;41;26603;Siqueira Campos;22487;324;22811
PR;41;26652;Sulina;3434;6;3440
PR;41;26678;Tamarana;10263;444;10707
PR;41;26702;Tamboara;4869;11;4880
PR;41;26801;Tapejara;15180;689;15869
PR;41;26900;Tapira;5724;21;5745
PR;41;27007;Teixeira Soares;9376;171;9547
PR;41;27106;Telêmaco Borba;72474;2568;75042
PR;41;27205;Terra Boa;17355;213;17568
PR;41;27304;Terra Rica;14159;683;14842
PR;41;27403;Terra Roxa;17443;676;18119
PR;41;27502;Tibagi;17908;2053;19961
PR;41;27601;Tijucas do Sul;17002;604;17606
PR;41;27700;Toledo;141077;9393;150470
PR;41;27809;Tomazina;8366;60;8426
PR;41;27858;Três Barras do Paraná;10837;298;11135
PR;41;27882;Tunas do Paraná;5941;278;6219
PR;41;27908;Tuneiras do Oeste;7994;73;8067
PR;41;27957;Tupãssi;7788;289;8077
PR;41;27965;Turvo;14186;45;14231
PR;41;28005;Ubiratã;24008;741;24749
PR;41;28104;Umuarama;114393;2702;117095
PR;41;28203;União da Vitória;52971;2062;55033
PR;41;28302;Uniflor;2128;8;2136
PR;41;28401;Uraí;10244;162;10406
PR;41;28500;Wenceslau Braz;19063;125;19188
PR;41;28534;Ventania;9676;5;9681
PR;41;28559;Vera Cruz do Oeste;7678;537;8215
PR;41;28609;Verê;7878;54;7932
PR;41;28625;Alto Paraíso;3036;19;3055
PR;41;28633;Doutor Ulysses;5667;30;5697
PR;41;28658;Virmond;3807;4;3811
PR;41;28708;Vitorino;9393;313;9706
PR;41;28807;Xambrê;5768;30;5798
SC;42;00051;Abdon Batista;2587;11;2598
SC;42;00101;Abelardo Luz;17314;78;17392
SC;42;00200;Agrolândia;10553;437;10990
SC;42;00309;Agronômica;5813;242;6055
SC;42;00408;Água Doce;6501;7;6508
SC;42;00507;Águas de Chapecó;5943;93;6036
SC;42;00556;Águas Frias;2759;80;2839
SC;42;00606;Águas Mornas;6569;174;6743
SC;42;00705;Alfredo Wagner;10232;249;10481
SC;42;00754;Alto Bela Vista;1852;4;1856
SC;42;00804;Anchieta;5899;44;5943
SC;42;00903;Angelina;5257;101;5358
SC;42;01000;Anita Garibaldi;8284;1;8285
SC;42;01109;Anitápolis;3423;170;3593
SC;42;01208;Antônio Carlos;10805;419;11224
SC;42;01257;Apiúna;9355;456;9811
SC;42;01273;Arabutã;4345;33;4378
SC;42;01307;Araquari;43938;1242;45180
SC;42;01406;Araranguá;70047;1875;71922
SC;42;01505;Armazém;8787;47;8834
SC;42;01604;Arroio Trinta;3546;10;3556
SC;42;01653;Arvoredo;2502;8;2510
SC;42;01703;Ascurra;8112;207;8319
SC;42;01802;Atalanta;3199;28;3227
SC;42;01901;Aurora;6584;196;6780
SC;42;01950;Balneário Arroio do Silva;15632;188;15820
SC;42;02008;Balneário Camboriú;135323;3832;139155
SC;42;02057;Balneário Barra do Sul;14688;224;14912
SC;42;02073;Balneário Gaivota;15392;277;15669
SC;42;02081;Bandeirante;3110;34;3144
SC;42;02099;Barra Bonita;1659;9;1668
SC;42;02107;Barra Velha;43739;1632;45371
SC;42;02131;Bela Vista do Toldo;5856;16;5872
SC;42;02156;Belmonte;2645;13;2658
SC;42;02206;Benedito Novo;10106;414;10520
SC;42;02305;Biguaçu;73508;3265;76773
SC;42;02404;Blumenau;347359;13902;361261
SC;42;02438;Bocaina do Sul;3509;6;3515
SC;42;02453;Bombinhas;24049;1009;25058
SC;42;02503;Bom Jardim da Serra;3995;31;4026
SC;42;02537;Bom Jesus;2774;3;2777
SC;42;02578;Bom Jesus do Oeste;2187;0;2187
SC;42;02602;Bom Retiro;8237;181;8418
SC;42;02701;Botuverá;5346;17;5363
SC;42;02800;Braço do Norte;32910;863;33773
SC;42;02859;Braço do Trombudo;3843;183;4026
SC;42;02875;Brunópolis;2448;41;2489
SC;42;02909;Brusque;136494;4891;141385
SC;42;03006;Caçador;72042;1678;73720
SC;42;03105;Caibi;6304;0;6304
SC;42;03154;Calmon;3393;50;3443
SC;42;03204;Camboriú;99447;3627;103074
SC;42;03253;Capão Alto;2519;106;2625
SC;42;03303;Campo Alegre;12383;118;12501
SC;42;03402;Campo Belo do Sul;7230;27;7257
SC;42;03501;Campo Erê;9558;65;9623
SC;42;03600;Campos Novos;36907;25;36932
SC;42;03709;Canelinha;12599;222;12821
SC;42;03808;Canoinhas;54381;635;55016
SC;42;03907;Capinzal;23290;24;23314
SC;42;03956;Capivari de Baixo;23449;526;23975
SC;42;04004;Catanduvas;10565;1;10566
SC;42;04103;Caxambu do Sul;4614;0;4614
SC;42;04152;Celso Ramos;2803;2;2805
SC;42;04178;Cerro Negro;3314;3;3317
SC;42;04194;Chapadão do Lageado;2938;12;2950
SC;42;04202;Chapecó;244872;9909;254781
SC;42;04251;Cocal do Sul;16478;762;17240
SC;42;04301;Concórdia;79353;2293;81646
SC;42;04350;Cordilheira Alta;4678;103;4781
SC;42;04400;Coronel Freitas;10098;290;10388
SC;42;04459;Coronel Martins;2065;0;2065
SC;42;04509;Corupá;14889;145;15034
SC;42;04558;Correia Pinto;15716;11;15727
SC;42;04608;Criciúma;206175;8318;214493
SC;42;04707;Cunha Porã;10951;2;10953
SC;42;04756;Cunhataí;1965;3;1968
SC;42;04806;Curitibanos;38734;1311;40045
SC;42;04905;Descanso;8422;108;8530
SC;42;05001;Dionísio Cerqueira;14881;127;15008
SC;42;05100;Dona Emma;4193;28;4221
SC;42;05159;Doutor Pedrinho;3503;134;3637
SC;42;05175;Entre Rios;3284;118;3402
SC;42;05191;Ermo;2218;51;2269
SC;42;05209;Erval Velho;4865;20;4885
SC;42;05308;Faxinal dos Guedes;10746;446;11192
SC;42;05357;Flor do Sertão;1783;0;1783
SC;42;05407;Florianópolis;519187;18026;537213
SC;42;05431;Formosa do Sul;2682;0;2682
SC;42;05456;Forquilhinha;30112;1319;31431
SC;42;05506;Fraiburgo;32548;933;33481
SC;42;05555;Frei Rogério;2411;0;2411
SC;42;05605;Galvão;3214;5;3219
SC;42;05704;Garopaba;28614;1345;29959
SC;42;05803;Garuva;17861;695;18556
SC;42;05902;Gaspar;69168;3402;72570
SC;42;06009;Governador Celso Ramos;16212;703;16915
SC;42;06108;Grão-Pará;6036;241;6277
SC;42;06207;Gravatal;11856;579;12435
SC;42;06306;Guabiruba;23952;591;24543
SC;42;06405;Guaraciaba;10773;23;10796
SC;42;06504;Guaramirim;45322;1389;46711
SC;42;06603;Guarujá do Sul;4828;1;4829
SC;42;06652;Guatambú;8251;174;8425
SC;42;06702;Herval d'Oeste;21696;28;21724
SC;42;06751;Ibiam;1976;32;2008
SC;42;06801;Ibicaré;3264;5;3269
SC;42;06900;Ibirama;19206;656;19862
SC;42;07007;Içara;56540;2495;59035
SC;42;07106;Ilhota;16431;615;17046
SC;42;07205;Imaruí;11447;434;11881
SC;42;07304;Imbituba;50489;2092;52581
SC;42;07403;Imbuia;5960;22;5982
SC;42;07502;Indaial;69292;2257;71549
SC;42;07577;Iomerê;2814;63;2877
SC;42;07601;Ipira;4510;68;4578
SC;42;07650;Iporã do Oeste;9333;0;9333
SC;42;07684;Ipuaçu;7492;9;7501
SC;42;07700;Ipumirim;7796;20;7816
SC;42;07759;Iraceminha;3981;5;3986
SC;42;07809;Irani;10143;52;10195
SC;42;07858;Irati;2069;0;2069
SC;42;07908;Irineópolis;10227;58;10285
SC;42;08005;Itá;6948;119;7067
SC;42;08104;Itaiópolis;22030;21;22051
SC;42;08203;Itajaí;253305;10749;264054
SC;42;08302;Itapema;72522;3418;75940
SC;42;08401;Itapiranga;16633;5;16638
SC;42;08450;Itapoá;29829;921;30750
SC;42;08500;Ituporanga;25553;972;26525
SC;42;08609;Jaborá;4310;0;4310
SC;42;08708;Jacinto Machado;10588;36;10624
SC;42;08807;Jaguaruna;19814;561;20375
SC;42;08906;Jaraguá do Sul;175836;6824;182660
SC;42;08955;Jardinópolis;1775;1;1776
SC;42;09003;Joaçaba;30144;2;30146
SC;42;09102;Joinville;594269;22054;616323
SC;42;09151;José Boiteux;5985;0;5985
SC;42;09177;Jupiá;2546;0;2546
SC;42;09201;Lacerdópolis;2248;0;2248
SC;42;09300;Lages;158699;6282;164981
SC;42;09409;Laguna;41767;1018;42785
SC;42;09458;Lajeado Grande;1680;22;1702
SC;42;09508;Laurentino;7569;363;7932
SC;42;09607;Lauro Müller;13736;645;14381
SC;42;09706;Lebon Régis;10968;504;11472
SC;42;09805;Leoberto Leal;3330;0;3330
SC;42;09854;Lindóia do Sul;4529;20;4549
SC;42;09904;Lontras;12602;271;12873
SC;42;10001;Luiz Alves;11376;308;11684
SC;42;10035;Luzerna;5775;19;5794
SC;42;10050;Macieira;1772;6;1778
SC;42;10100;Mafra;54037;1249;55286
SC;42;10209;Major Gercino;3116;98;3214
SC;42;10308;Major Vieira;7352;73;7425
SC;42;10407;Maracajá;7735;80;7815
SC;42;10506;Maravilha;27717;534;28251
SC;42;10555;Marema;2171;13;2184
SC;42;10605;Massaranduba;16591;571;17162
SC;42;10704;Matos Costa;2742;19;2761
SC;42;10803;Meleiro;6980;26;7006
SC;42;10852;Mirim Doce;2479;19;2498
SC;42;10902;Modelo;4080;0;4080
SC;42;11009;Mondaí;10063;3;10066
SC;42;11058;Monte Carlo;9095;22;9117
SC;42;11108;Monte Castelo;7690;46;7736
SC;42;11207;Morro da Fumaça;17790;747;18537
SC;42;11256;Morro Grande;2948;62;3010
SC;42;11306;Navegantes;83010;3391;86401
SC;42;11405;Nova Erechim;4956;199;5155
SC;42;11454;Nova Itaberaba;4324;212;4536
SC;42;11504;Nova Trento;13313;414;13727
SC;42;11603;Nova Veneza;13087;577;13664
SC;42;11652;Novo Horizonte;2635;15;2650
SC;42;11702;Orleans;22626;1035;23661
SC;42;11751;Otacílio Costa;17286;26;17312
SC;42;11801;Ouro;7032;0;7032
SC;42;11850;Ouro Verde;2181;0;2181
SC;42;11876;Paial;1903;24;1927
SC;42;11892;Painel;2164;51;2215
SC;42;11900;Palhoça;214224;8374;222598
SC;42;12007;Palma Sola;7492;113;7605
SC;42;12056;Palmeira;2550;11;2561
SC;42;12106;Palmitos;15626;0;15626
SC;42;12205;Papanduva;19100;50;19150
SC;42;12239;Paraíso;4261;6;4267
SC;42;12254;Passo de Torres;12773;124;12897
SC;42;12270;Passos Maia;4021;13;4034
SC;42;12304;Paulo Lopes;8974;92;9066
SC;42;12403;Pedras Grandes;4214;31;4245
SC;42;12502;Penha;32142;1521;33663
SC;42;12601;Peritiba;2955;37;2992
SC;42;12650;Pescaria Brava;9893;297;10190
SC;42;12700;Petrolândia;6678;38;6716
SC;42;12809;Balneário Piçarras;26384;743;27127
SC;42;12908;Pinhalzinho;21229;743;21972
SC;42;13005;Pinheiro Preto;3460;13;3473
SC;42;13104;Piratuba;5673;96;5769
SC;42;13153;Planalto Alegre;2946;0;2946
SC;42;13203;Pomerode;33078;1185;34263
SC;42;13302;Ponte Alta;4373;64;4437
SC;42;13351;Ponte Alta do Norte;3139;71;3210
SC;42;13401;Ponte Serrada;10524;125;10649
SC;42;13500;Porto Belo;26659;1029;27688
SC;42;13609;Porto União;32380;590;32970
SC;42;13708;Pouso Redondo;16999;126;17125
SC;42;13807;Praia Grande;8191;79;8270
SC;42;13906;Presidente Castello Branco;1672;17;1689
SC;42;14003;Presidente Getúlio;19396;614;20010
SC;42;14102;Presidente Nereu;2287;14;2301
SC;42;14151;Princesa;2964;0;2964
SC;42;14201;Quilombo;10934;3;10937
SC;42;14300;Rancho Queimado;3199;80;3279
SC;42;14409;Rio das Antas;6163;90;6253
SC;42;14508;Rio do Campo;6405;47;6452
SC;42;14607;Rio do Oeste;7583;164;7747
SC;42;14706;Rio dos Cedros;10499;366;10865
SC;42;14805;Rio do Sul;69618;2969;72587
SC;42;14904;Rio Fortuna;4702;145;4847
SC;42;15000;Rio Negrinho;38688;570;39258
SC;42;15059;Rio Rufino;2374;23;2397
SC;42;15075;Riqueza;4766;2;4768
SC;42;15109;Rodeio;12349;408;12757
SC;42;15208;Romelândia;4807;16;4823
SC;42;15307;Salete;7403;86;7489
SC;42;15356;Saltinho;3621;11;3632
SC;42;15406;Salto Veloso;4324;66;4390
SC;42;15455;Sangão;12570;312;12882
SC;42;15505;Santa Cecília;15361;185;15546
SC;42;15554;Santa Helena;2415;10;2425
SC;42;15604;Santa Rosa de Lima;2085;3;2088
SC;42;15653;Santa Rosa do Sul;9683;109;9792
SC;42;15679;Santa Terezinha;8007;59;8066
SC;42;15687;Santa Terezinha do Progresso;2552;24;2576
SC;42;15695;Santiago do Sul;1651;0;1651
SC;42;15703;Santo Amaro da Imperatriz;26433;839;27272
SC;42;15752;São Bernardino;2671;13;2684
SC;42;15802;São Bento do Sul;80298;2977;83275
SC;42;15901;São Bonifácio;2886;60;2946
SC;42;16008;São Carlos;10282;0;10282
SC;42;16057;São Cristóvão do Sul;6064;20;6084
SC;42;16107;São Domingos;9226;0;9226
SC;42;16206;São Francisco do Sul;50392;2282;52674
SC;42;16255;São João do Oeste;6293;2;6295
SC;42;16305;São João Batista;31411;1276;32687
SC;42;16354;São João do Itaperiú;4405;58;4463
SC;42;16404;São João do Sul;8557;111;8668
SC;42;16503;São Joaquim;25878;61;25939
SC;42;16602;São José;260650;9645;270295
SC;42;16701;São José do Cedro;14130;37;14167
SC;42;16800;São José do Cerrito;8703;5;8708
SC;42;16909;São Lourenço do Oeste;24659;126;24785
SC;42;17006;São Ludgero;13459;50;13509
SC;42;17105;São Martinho;3276;129;3405
SC;42;17154;São Miguel da Boa Vista;1781;0;1781
SC;42;17204;São Miguel do Oeste;43752;578;44330
SC;42;17253;São Pedro de Alcântara;5620;156;5776
SC;42;17303;Saudades;10163;102;10265
SC;42;17402;Schroeder;19613;448;20061
SC;42;17501;Seara;18416;204;18620
SC;42;17550;Serra Alta;3303;0;3303
SC;42;17600;Siderópolis;13512;202;13714
SC;42;17709;Sombrio;29823;168;29991
SC;42;17758;Sul Brasil;2716;116;2832
SC;42;17808;Taió;17728;590;18318
SC;42;17907;Tangará;8114;29;8143
SC;42;17956;Tigrinhos;2325;4;2329
SC;42;18004;Tijucas;49503;2089;51592
SC;42;18103;Timbé do Sul;5353;33;5386
SC;42;18202;Timbó;44303;1796;46099
SC;42;18251;Timbó Grande;7316;26;7342
SC;42;18301;Três Barras;19687;59;19746
SC;42;18350;Treviso;3585;104;3689
SC;42;18400;Treze de Maio;7347;15;7362
SC;42;18509;Treze Tílias;8782;5;8787
SC;42;18608;Trombudo Central;6944;330;7274
SC;42;18707;Tubarão;106964;3124;110088
SC;42;18756;Tunápolis;4914;2;4916
SC;42;18806;Turvo;12993;50;13043
SC;42;18855;União do Oeste;2728;46;2774
SC;42;18905;Urubici;10698;136;10834
SC;42;18954;Urupema;2596;60;2656
SC;42;19002;Urussanga;20345;574;20919
SC;42;19101;Vargeão;3467;167;3634
SC;42;19150;Vargem;2614;13;2627
SC;42;19176;Vargem Bonita;4576;0;4576
SC;42;19200;Vidal Ramos;6094;95;6189
SC;42;19309;Videira;53659;1807;55466
SC;42;19358;Vitor Meireles;5325;45;5370
SC;42;19408;Witmarsum;4215;40;4255
SC;42;19507;Xanxerê;49352;2255;51607
SC;42;19606;Xavantina;3647;6;3653
SC;42;19705;Xaxim;30467;1451;31918
SC;42;19853;Zortéa;3907;23;3930
SC;42;20000;Balneário Rincão;15265;716;15981
RS;43;00034;Aceguá;4098;72;4170
RS;43;00059;Água Santa;3880;32;3912
RS;43;00109;Agudo;15871;168;16039
RS;43;00208;Ajuricaba;6710;10;6720
RS;43;00307;Alecrim;6088;35;6123
RS;43;00406;Alegrete;72356;53;72409
RS;43;00455;Alegria;3649;2;3651
RS;43;00471;Almirante Tamandaré do Sul;1927;42;1969
RS;43;00505;Alpestre;7043;74;7117
RS;43;00554;Alto Alegre;1800;0;1800
RS;43;00570;Alto Feliz;3062;10;3072
RS;43;00604;Alvorada;182343;4972;187315
RS;43;00638;Amaral Ferrador;5288;22;5310
RS;43;00646;Ametista do Sul;7586;64;7650
RS;43;00661;André da Rocha;1111;24;1135
RS;43;00703;Anta Gorda;5925;32;5957
RS;43;00802;Antônio Prado;12487;493;12980
RS;43;00851;Arambaré;4088;24;4112
RS;43;00877;Araricá;8312;213;8525
RS;43;00901;Aratiba;6438;45;6483
RS;43;01008;Arroio do Meio;21730;233;21963
RS;43;01057;Arroio do Sal;10747;310;11057
RS;43;01073;Arroio do Padre;2597;2;2599
RS;43;01107;Arroio dos Ratos;14601;0;14601
RS;43;01206;Arroio do Tigre;11964;94;12058
RS;43;01305;Arroio Grande;17500;58;17558
RS;43;01404;Arvorezinha;10302;20;10322
RS;43;01503;Augusto Pestana;7149;0;7149
RS;43;01552;Áurea;3395;1;3396
RS;43;01602;Bagé;114574;3364;117938
RS;43;01636;Balneário Pinhal;14781;174;14955
RS;43;01651;Barão;6380;81;6461
RS;43;01701;Barão de Cotegipe;7142;2;7144
RS;43;01750;Barão do Triunfo;5889;0;5889
RS;43;01800;Barracão;4790;41;4831
RS;43;01859;Barra do Guarita;3158;3;3161
RS;43;01875;Barra do Quaraí;4072;169;4241
RS;43;01909;Barra do Ribeiro;12043;182;12225
RS;43;01925;Barra do Rio Azul;1689;7;1696
RS;43;01958;Barra Funda;2498;0;2498
RS;43;02006;Barros Cassal;9296;0;9296
RS;43;02055;Benjamin Constant do Sul;2062;20;2082
RS;43;02105;Bento Gonçalves;118627;4524;123151
RS;43;02154;Boa Vista das Missões;1927;6;1933
RS;43;02204;Boa Vista do Buricá;6922;44;6966
RS;43;02220;Boa Vista do Cadeado;2229;0;2229
RS;43;02238;Boa Vista do Incra;2266;5;2271
RS;43;02253;Boa Vista do Sul;2764;15;2779
RS;43;02303;Bom Jesus;11000;202;11202
RS;43;02352;Bom Princípio;12902;230;13132
RS;43;02378;Bom Progresso;2081;15;2096
RS;43;02402;Bom Retiro do Sul;12167;127;12294
RS;43;02451;Boqueirão do Leão;6247;0;6247
RS;43;02501;Bossoroca;5886;4;5890
RS;43;02584;Bozano;2151;0;2151
RS;43;02600;Braga;3266;2;3268
RS;43;02659;Brochier;4966;0;4966
RS;43;02709;Butiá;19043;41;19084
RS;43;02808;Caçapava do Sul;32194;321;32515
RS;43;02907;Cacequi;11125;32;11157
RS;43;03004;Cachoeira do Sul;78586;1484;80070
RS;43;03103;Cachoeirinha;132706;3552;136258
RS;43;03202;Cacique Doble;4595;8;4603
RS;43;03301;Caibaté;4690;14;4704
RS;43;03400;Caiçara;4811;25;4836
RS;43;03509;Camaquã;61517;683;62200
RS;43;03558;Camargo;2968;13;2981
RS;43;03608;Cambará do Sul;6348;13;6361
RS;43;03673;Campestre da Serra;3236;6;3242
RS;43;03707;Campina das Missões;5880;2;5882
RS;43;03806;Campinas do Sul;5261;23;5284
RS;43;03905;Campo Bom;60852;2034;62886
RS;43;04002;Campo Novo;4965;10;4975
RS;43;04101;Campos Borges;3613;0;3613
RS;43;04200;Candelária;28686;220;28906
RS;43;04309;Cândido Godói;6293;1;6294
RS;43;04358;Candiota;10363;347;10710
RS;43;04408;Canela;47518;1428;48946
RS;43;04507;Canguçu;48809;871;49680
RS;43;04606;Canoas;335359;12298;347657
RS;43;04614;Canudos do Vale;1644;12;1656
RS;43;04622;Capão Bonito do Sul;1732;1;1733
RS;43;04630;Capão da Canoa;62397;1197;63594
RS;43;04655;Capão do Cipó;3105;14;3119
RS;43;04663;Capão do Leão;26084;403;26487
RS;43;04671;Capivari do Sul;3873;118;3991
RS;43;04689;Capela de Santana;10912;247;11159
RS;43;04697;Capitão;2897;20;2917
RS;43;04705;Carazinho;60886;918;61804
RS;43;04713;Caraá;7338;22;7360
RS;43;04804;Carlos Barbosa;29945;473;30418
RS;43;04853;Carlos Gomes;1361;7;1368
RS;43;04903;Casca;9465;0;9465
RS;43;04952;Caseiros;3000;0;3000
RS;43;05009;Catuípe;8671;3;8674
RS;43;05108;Caxias do Sul;445288;18050;463338
RS;43;05116;Centenário;2721;0;2721
RS;43;05124;Cerrito;5745;63;5808
RS;43;05132;Cerro Branco;3800;2;3802
RS;43;05157;Cerro Grande;2379;0;2379
RS;43;05173;Cerro Grande do Sul;9152;26;9178
RS;43;05207;Cerro Largo;13671;34;13705
RS;43;05306;Chapada;9525;15;9540
RS;43;05355;Charqueadas;34680;332;35012
RS;43;05371;Charrua;2750;18;2768
RS;43;05405;Chiapetta;3913;0;3913
RS;43;05439;Chuí;6009;253;6262
RS;43;05447;Chuvisca;4585;12;4597
RS;43;05454;Cidreira;16853;218;17071
RS;43;05504;Ciríaco;4146;0;4146
RS;43;05587;Colinas;2421;2;2423
RS;43;05603;Colorado;3258;0;3258
RS;43;05702;Condor;6400;6;6406
RS;43;05801;Constantina;10354;31;10385
RS;43;05835;Coqueiro Baixo;1284;6;1290
RS;43;05850;Coqueiros do Sul;2207;4;2211
RS;43;05871;Coronel Barros;2822;0;2822
RS;43;05900;Coronel Bicaco;6126;18;6144
RS;43;05934;Coronel Pilar;1600;7;1607
RS;43;05959;Cotiporã;3828;18;3846
RS;43;05975;Coxilha;2635;32;2667
RS;43;06007;Crissiumal;12824;62;12886
RS;43;06056;Cristal;7290;9;7299
RS;43;06072;Cristal do Sul;2688;4;2692
RS;43;06106;Cruz Alta;58515;398;58913
RS;43;06130;Cruzaltense;1629;6;1635
RS;43;06205;Cruzeiro do Sul;11472;128;11600
RS;43;06304;David Canabarro;4321;0;4321
RS;43;06320;Derrubadas;2749;2;2751
RS;43;06353;Dezesseis de Novembro;2499;8;2507
RS;43;06379;Dilermando de Aguiar;2803;3;2806
RS;43;06403;Dois Irmãos;30200;509;30709
RS;43;06429;Dois Irmãos das Missões;2086;4;2090
RS;43;06452;Dois Lajeados;3021;76;3097
RS;43;06502;Dom Feliciano;13028;23;13051
RS;43;06551;Dom Pedro de Alcântara;2562;0;2562
RS;43;06601;Dom Pedrito;36631;350;36981
RS;43;06700;Dona Francisca;3076;3;3079
RS;43;06734;Doutor Maurício Cardoso;4470;0;4470
RS;43;06759;Doutor Ricardo;1874;14;1888
RS;43;06767;Eldorado do Sul;38503;1056;39559
RS;43;06809;Encantado;22275;687;22962
RS;43;06908;Encruzilhada do Sul;23817;2;23819
RS;43;06924;Engenho Velho;1279;17;1296
RS;43;06932;Entre-Ijuís;9139;19;9158
RS;43;06957;Entre Rios do Sul;2638;47;2685
RS;43;06973;Erebango;3023;31;3054
RS;43;07005;Erechim;102828;2877;105705
RS;43;07054;Ernestina;3017;17;3034
RS;43;07104;Herval;6018;173;6191
RS;43;07203;Erval Grande;4893;37;4930
RS;43;07302;Erval Seco;6781;6;6787
RS;43;07401;Esmeralda;3174;21;3195
RS;43;07450;Esperança do Sul;3223;3;3226
RS;43;07500;Espumoso;14994;179;15173
RS;43;07559;Estação;5471;111;5582
RS;43;07609;Estância Velha;46526;1386;47912
RS;43;07708;Esteio;73890;2247;76137
RS;43;07807;Estrela;31371;812;32183
RS;43;07815;Estrela Velha;3058;12;3070
RS;43;07831;Eugênio de Castro;2633;0;2633
RS;43;07864;Fagundes Varela;2566;0;2566
RS;43;07906;Farroupilha;67533;2352;69885
RS;43;08003;Faxinal do Soturno;6697;5;6702
RS;43;08052;Faxinalzinho;2499;21;2520
RS;43;08078;Fazenda Vilanova;4230;61;4291
RS;43;08102;Feliz;13339;425;13764
RS;43;08201;Flores da Cunha;30097;795;30892
RS;43;08250;Floriano Peixoto;1666;2;1668
RS;43;08300;Fontoura Xavier;9550;0;9550
RS;43;08409;Formigueiro;6239;174;6413
RS;43;08433;Forquetinha;2380;13;2393
RS;43;08458;Fortaleza dos Valos;4458;19;4477
RS;43;08508;Frederico Westphalen;31846;781;32627
RS;43;08607;Garibaldi;33604;731;34335
RS;43;08656;Garruchos;2669;19;2688
RS;43;08706;Gaurama;5637;28;5665
RS;43;08805;General Câmara;7577;35;7612
RS;43;08854;Gentil;1740;2;1742
RS;43;08904;Getúlio Vargas;16321;281;16602
RS;43;09001;Giruá;15869;144;16013
RS;43;09050;Glorinha;7657;1;7658
RS;43;09100;Gramado;38852;1282;40134
RS;43;09126;Gramado dos Loureiros;2003;11;2014
RS;43;09159;Gramado Xavier;3304;0;3304
RS;43;09209;Gravataí;258741;6329;265070
RS;43;09258;Guabiju;1403;14;1417
RS;43;09308;Guaíba;89646;3278;92924
RS;43;09407;Guaporé;25048;220;25268
RS;43;09506;Guarani das Missões;7392;23;7415
RS;43;09555;Harmonia;5289;89;5378
RS;43;09571;Herveiras;2526;0;2526
RS;43;09605;Horizontina;18851;0;18851
RS;43;09654;Hulha Negra;5889;87;5976
RS;43;09704;Humaitá;4675;6;4681
RS;43;09753;Ibarama;3698;34;3732
RS;43;09803;Ibiaçá;4508;19;4527
RS;43;09902;Ibiraiaras;6775;1;6776
RS;43;09951;Ibirapuitã;3714;9;3723
RS;43;10009;Ibirubá;21523;60;21583
RS;43;10108;Igrejinha;32184;624;32808
RS;43;10207;Ijuí;83805;921;84726
RS;43;10306;Ilópolis;4157;0;4157
RS;43;10330;Imbé;25771;1053;26824
RS;43;10363;Imigrante;3077;3;3080
RS;43;10405;Independência;6348;79;6427
RS;43;10413;Inhacorá;2012;2;2014
RS;43;10439;Ipê;5160;165;5325
RS;43;10462;Ipiranga do Sul;1709;11;1720
RS;43;10504;Iraí;7391;91;7482
RS;43;10538;Itaara;5336;236;5572
RS;43;10553;Itacurubi;2995;0;2995
RS;43;10579;Itapuca;1937;0;1937
RS;43;10603;Itaqui;34948;820;35768
RS;43;10652;Itati;2588;50;2638
RS;43;10702;Itatiba do Sul;3194;14;3208
RS;43;10751;Ivorá;1926;3;1929
RS;43;10801;Ivoti;22680;303;22983
RS;43;10850;Jaboticaba;3774;5;3779
RS;43;10876;Jacuizinho;2029;11;2040
RS;43;10900;Jacutinga;3318;20;3338
RS;43;11007;Jaguarão;25681;922;26603
RS;43;11106;Jaguari;10567;12;10579
RS;43;11122;Jaquirana;3668;22;3690
RS;43;11130;Jari;3341;8;3349
RS;43;11155;Jóia;7182;2;7184
RS;43;11205;Júlio de Castilhos;18063;163;18226
RS;43;11239;Lagoa Bonita do Sul;2240;11;2251
RS;43;11254;Lagoão;5327;14;5341
RS;43;11270;Lagoa dos Três Cantos;1738;0;1738
RS;43;11304;Lagoa Vermelha;27629;30;27659
RS;43;11403;Lajeado;90378;3268;93646
RS;43;11429;Lajeado do Bugre;2595;6;2601
RS;43;11502;Lavras do Sul;7059;98;7157
RS;43;11601;Liberato Salzano;4770;11;4781
RS;43;11627;Lindolfo Collor;6105;139;6244
RS;43;11643;Linha Nova;1683;0;1683
RS;43;11700;Machadinho;5699;36;5735
RS;43;11718;Maçambará;4421;4;4425
RS;43;11734;Mampituba;3109;22;3131
RS;43;11759;Manoel Viana;6798;3;6801
RS;43;11775;Maquiné;7317;101;7418
RS;43;11791;Maratá;2470;0;2470
RS;43;11809;Marau;44558;568;45126
RS;43;11908;Marcelino Ramos;4299;21;4320
RS;43;11981;Mariana Pimentel;3900;16;3916
RS;43;12005;Mariano Moro;1812;46;1858
RS;43;12054;Marques de Souza;3900;69;3969
RS;43;12104;Mata;4690;8;4698
RS;43;12138;Mato Castelhano;2525;28;2553
RS;43;12153;Mato Leitão;4859;0;4859
RS;43;12179;Mato Queimado;1786;9;1795
RS;43;12203;Maximiliano de Almeida;4114;77;4191
RS;43;12252;Minas do Leão;7504;1;7505
RS;43;12302;Miraguaí;4427;0;4427
RS;43;12351;Montauri;1476;23;1499
RS;43;12377;Monte Alegre dos Campos;3160;20;3180
RS;43;12385;Monte Belo do Sul;2531;26;2557
RS;43;12401;Montenegro;62386;1238;63624
RS;43;12427;Mormaço;2739;17;2756
RS;43;12443;Morrinhos do Sul;3069;2;3071
RS;43;12450;Morro Redondo;5930;116;6046
RS;43;12476;Morro Reuter;5920;109;6029
RS;43;12500;Mostardas;11946;144;12090
RS;43;12609;Muçum;4555;46;4601
RS;43;12617;Muitos Capões;2875;4;2879
RS;43;12625;Muliterno;1721;0;1721
RS;43;12658;Não-Me-Toque;17859;39;17898
RS;43;12674;Nicolau Vergueiro;1930;2;1932
RS;43;12708;Nonoai;13597;122;13719
RS;43;12757;Nova Alvorada;3152;11;3163
RS;43;12807;Nova Araçá;4897;57;4954
RS;43;12906;Nova Bassano;9586;63;9649
RS;43;12955;Nova Boa Vista;2042;0;2042
RS;43;13003;Nova Bréscia;3027;17;3044
RS;43;13011;Nova Candelária;3061;0;3061
RS;43;13037;Nova Esperança do Sul;4859;6;4865
RS;43;13060;Nova Hartz;19486;602;20088
RS;43;13086;Nova Pádua;2307;36;2343
RS;43;13102;Nova Palma;5528;58;5586
RS;43;13201;Nova Petrópolis;22301;876;23177
RS;43;13300;Nova Prata;25091;601;25692
RS;43;13334;Nova Ramada;2163;0;2163
RS;43;13359;Nova Roma do Sul;3465;1;3466
RS;43;13375;Nova Santa Rita;27892;1132;29024
RS;43;13391;Novo Cabrais;3552;16;3568
RS;43;13409;Novo Hamburgo;219756;7976;227732
RS;43;13425;Novo Machado;3198;0;3198
RS;43;13441;Novo Tiradentes;2145;1;2146
RS;43;13466;Novo Xingu;1638;8;1646
RS;43;13490;Novo Barreiro;4261;11;4272
RS;43;13508;Osório;46265;1135;47400
RS;43;13607;Paim Filho;3610;19;3629
RS;43;13656;Palmares do Sul;12700;144;12844
RS;43;13706;Palmeira das Missões;33212;4;33216
RS;43;13805;Palmitinho;7837;2;7839
RS;43;13904;Panambi;43402;113;43515
RS;43;13953;Pantano Grande;10212;0;10212
RS;43;14001;Paraí;6986;208;7194
RS;43;14027;Paraíso do Sul;6303;216;6519
RS;43;14035;Pareci Novo;4171;148;4319
RS;43;14050;Parobé;50487;1571;52058
RS;43;14068;Passa Sete;3894;88;3982
RS;43;14076;Passo do Sobrado;6025;0;6025
RS;43;14100;Passo Fundo;200360;5864;206224
RS;43;14134;Paulo Bento;2142;2;2144
RS;43;14159;Paverama;7856;122;7978
RS;43;14175;Pedras Altas;1969;92;2061
RS;43;14209;Pedro Osório;7298;186;7484
RS;43;14308;Pejuçara;3727;18;3745
RS;43;14407;Pelotas;315479;10210;325689
RS;43;14423;Picada Café;5220;131;5351
RS;43;14456;Pinhal;2945;14;2959
RS;43;14464;Pinhal da Serra;2240;8;2248
RS;43;14472;Pinhal Grande;3753;52;3805
RS;43;14498;Pinheirinho do Vale;4534;6;4540
RS;43;14506;Pinheiro Machado;10925;289;11214
RS;43;14548;Pinto Bandeira;2723;0;2723
RS;43;14555;Pirapó;2255;5;2260
RS;43;14605;Piratini;17064;438;17502
RS;43;14704;Planalto;10395;11;10406
RS;43;14753;Poço das Antas;2164;7;2171
RS;43;14779;Pontão;3296;0;3296
RS;43;14787;Ponte Preta;1575;0;1575
RS;43;14803;Portão;33566;506;34072
RS;43;14902;Porto Alegre;1288037;44533;1332570
RS;43;15008;Porto Lucena;4360;0;4360
RS;43;15057;Porto Mauá;2134;8;2142
RS;43;15073;Porto Vera Cruz;1560;0;1560
RS;43;15107;Porto Xavier;9934;4;9938
RS;43;15131;Pouso Novo;1739;0;1739
RS;43;15149;Presidente Lucena;3077;0;3077
RS;43;15156;Progresso;5340;0;5340
RS;43;15172;Protásio Alves;2022;3;2025
RS;43;15206;Putinga;3738;9;3747
RS;43;15305;Quaraí;23414;86;23500
RS;43;15313;Quatro Irmãos;1552;0;1552
RS;43;15321;Quevedos;2497;10;2507
RS;43;15354;Quinze de Novembro;3910;0;3910
RS;43;15404;Redentora;9725;13;9738
RS;43;15453;Relvado;1795;1;1796
RS;43;15503;Restinga Sêca;14738;201;14939
RS;43;15552;Rio dos Índios;2804;31;2835
RS;43;15602;Rio Grande;184886;7014;191900
RS;43;15701;Rio Pardo;34654;0;34654
RS;43;15750;Riozinho;4465;8;4473
RS;43;15800;Roca Sales;10354;64;10418
RS;43;15909;Rodeio Bonito;6641;13;6654
RS;43;15958;Rolador;2282;9;2291
RS;43;16006;Rolante;20786;467;21253
RS;43;16105;Ronda Alta;9556;221;9777
RS;43;16204;Rondinha;4989;2;4991
RS;43;16303;Roque Gonzales;6576;0;6576
RS;43;16402;Rosário do Sul;36227;403;36630
RS;43;16428;Sagrada Família;2477;3;2480
RS;43;16436;Saldanha Marinho;2555;20;2575
RS;43;16451;Salto do Jacuí;10052;151;10203
RS;43;16477;Salvador das Missões;2876;1;2877
RS;43;16501;Salvador do Sul;6783;96;6879
RS;43;16600;Sananduva;16261;138;16399
RS;43;16709;Santa Bárbara do Sul;8054;68;8122
RS;43;16733;Santa Cecília do Sul;1665;9;1674
RS;43;16758;Santa Clara do Sul;6802;85;6887
RS;43;16808;Santa Cruz do Sul;133215;15;133230
RS;43;16907;Santa Maria;263477;8156;271633
RS;43;16956;Santa Maria do Herval;6241;99;6340
RS;43;16972;Santa Margarida do Sul;2587;9;2596
RS;43;17004;Santana da Boa Vista;7006;18;7024
RS;43;17103;Sant'Ana do Livramento;83518;903;84421
RS;43;17202;Santa Rosa;75759;1204;76963
RS;43;17251;Santa Tereza;1497;8;1505
RS;43;17301;Santa Vitória do Palmar;29613;1370;30983
RS;43;17400;Santiago;48874;64;48938
RS;43;17509;Santo Ângelo;75580;1337;76917
RS;43;17558;Santo Antônio do Palma;2091;0;2091
RS;43;17608;Santo Antônio da Patrulha;42533;409;42942
RS;43;17707;Santo Antônio das Missões;10258;42;10300
RS;43;17756;Santo Antônio do Planalto;2078;11;2089
RS;43;17806;Santo Augusto;13811;91;13902
RS;43;17905;Santo Cristo;15182;138;15320
RS;43;17954;Santo Expedito do Sul;2345;4;2349
RS;43;18002;São Borja;58522;1154;59676
RS;43;18051;São Domingos do Sul;2752;2;2754
RS;43;18101;São Francisco de Assis;17587;31;17618
RS;43;18200;São Francisco de Paula;21431;462;21893
RS;43;18309;São Gabriel;57268;1219;58487
RS;43;18408;São Jerônimo;20828;200;21028
RS;43;18424;São João da Urtiga;4447;14;4461
RS;43;18432;São João do Polêsine;2649;0;2649
RS;43;18440;São Jorge;2912;0;2912
RS;43;18457;São José das Missões;2362;0;2362
RS;43;18465;São José do Herval;1894;8;1902
RS;43;18481;São José do Hortêncio;4446;1;4447
RS;43;18499;São José do Inhacorá;2388;18;2406
RS;43;18507;São José do Norte;25233;210;25443
RS;43;18606;São José do Ouro;6767;67;6834
RS;43;18614;São José do Sul;2231;54;2285
RS;43;18622;São José dos Ausentes;4162;10;4172
RS;43;18705;São Leopoldo;212454;4956;217410
RS;43;18804;São Lourenço do Sul;41696;293;41989
RS;43;18903;São Luiz Gonzaga;34386;366;34752
RS;43;19000;São Marcos;20260;824;21084
RS;43;19109;São Martinho;5479;2;5481
RS;43;19125;São Martinho da Serra;2766;56;2822
RS;43;19158;São Miguel das Missões;7001;55;7056
RS;43;19208;São Nicolau;5109;9;5118
RS;43;19307;São Paulo das Missões;5841;5;5846
RS;43;19356;São Pedro da Serra;3439;109;3548
RS;43;19364;São Pedro das Missões;1757;0;1757
RS;43;19372;São Pedro do Butiá;3070;0;3070
RS;43;19406;São Pedro do Sul;15554;23;15577
RS;43;19505;São Sebastião do Caí;23970;458;24428
RS;43;19604;São Sepé;20796;423;21219
RS;43;19703;São Valentim;3258;6;3264
RS;43;19711;São Valentim do Sul;2170;37;2207
RS;43;19737;São Valério do Sul;2536;7;2543
RS;43;19752;São Vendelino;2251;0;2251
RS;43;19802;São Vicente do Sul;8088;9;8097
RS;43;19901;Sapiranga;73594;2054;75648
RS;43;20008;Sapucaia do Sul;127250;4857;132107
RS;43;20107;Sarandi;22683;168;22851
RS;43;20206;Seberi;11923;27;11950
RS;43;20230;Sede Nova;2692;12;2704
RS;43;20263;Segredo;6000;9;6009
RS;43;20305;Selbach;5092;15;5107
RS;43;20321;Senador Salgado Filho;2673;0;2673
RS;43;20354;Sentinela do Sul;5279;27;5306
RS;43;20404;Serafina Corrêa;16600;361;16961
RS;43;20453;Sério;1941;0;1941
RS;43;20503;Sertão;5539;2;5541
RS;43;20552;Sertão Santana;5849;14;5863
RS;43;20578;Sete de Setembro;1830;0;1830
RS;43;20602;Severiano de Almeida;3271;135;3406
RS;43;20651;Silveira Martins;2100;49;2149
RS;43;20677;Sinimbu;8578;0;8578
RS;43;20701;Sobradinho;14076;150;14226
RS;43;20800;Soledade;29953;38;29991
RS;43;20859;Tabaí;4358;103;4461
RS;43;20909;Tapejara;24177;380;24557
RS;43;21006;Tapera;10439;153;10592
RS;43;21105;Tapes;14568;91;14659
RS;43;21204;Taquara;52279;963;53242
RS;43;21303;Taquari;24783;415;25198
RS;43;21329;Taquaruçu do Sul;3108;11;3119
RS;43;21352;Tavares;5209;3;5212
RS;43;21402;Tenente Portela;14451;46;14497
RS;43;21436;Terra de Areia;10172;114;10286
RS;43;21451;Teutônia;32294;503;32797
RS;43;21469;Tio Hugo;3198;69;3267
RS;43;21477;Tiradentes do Sul;5129;0;5129
RS;43;21493;Toropi;2532;22;2554
RS;43;21501;Torres;40238;1513;41751
RS;43;21600;Tramandaí;52743;1644;54387
RS;43;21626;Travesseiro;2144;8;2152
RS;43;21634;Três Arroios;2579;12;2591
RS;43;21667;Três Cachoeiras;10951;11;10962
RS;43;21709;Três Coroas;24085;340;24425
RS;43;21808;Três de Maio;24726;190;24916
RS;43;21832;Três Forquilhas;2748;12;2760
RS;43;21857;Três Palmeiras;4634;82;4716
RS;43;21907;Três Passos;25083;353;25436
RS;43;21956;Trindade do Sul;7358;198;7556
RS;43;22004;Triunfo;27339;159;27498
RS;43;22103;Tucunduva;5531;11;5542
RS;43;22152;Tunas;3677;4;3681
RS;43;22186;Tupanci do Sul;1370;4;1374
RS;43;22202;Tupanciretã;19869;136;20005
RS;43;22251;Tupandi;4942;87;5029
RS;43;22301;Tuparendi;8335;28;8363
RS;43;22327;Turuçu;3361;58;3419
RS;43;22343;Ubiretama;1984;10;1994
RS;43;22350;União da Serra;1158;12;1170
RS;43;22376;Unistalda;1993;2;1995
RS;43;22400;Uruguaiana;113505;3705;117210
RS;43;22509;Vacaria;63475;712;64187
RS;43;22525;Vale Verde;3136;14;3150
RS;43;22533;Vale do Sol;9614;3;9617
RS;43;22541;Vale Real;5934;124;6058
RS;43;22558;Vanini;2004;0;2004
RS;43;22608;Venâncio Aires;68653;0;68653
RS;43;22707;Vera Cruz;26708;2;26710
RS;43;22806;Veranópolis;22883;1138;24021
RS;43;22855;Vespasiano Corrêa;1816;2;1818
RS;43;22905;Viadutos;4764;5;4769
RS;43;23002;Viamão;219643;4473;224116
RS;43;23101;Vicente Dutra;4635;30;4665
RS;43;23200;Victor Graeff;2737;43;2780
RS;43;23309;Vila Flores;3562;84;3646
RS;43;23358;Vila Lângaro;2055;24;2079
RS;43;23408;Vila Maria;4406;7;4413
RS;43;23457;Vila Nova do Sul;3670;193;3863
RS;43;23507;Vista Alegre;2656;4;2660
RS;43;23606;Vista Alegre do Prata;1552;38;1590
RS;43;23705;Vista Gaúcha;2783;0;2783
RS;43;23754;Vitória das Missões;3258;2;3260
RS;43;23770;Westfália;3077;21;3098
RS;43;23804;Xangri-lá;15952;511;16463
MS;50;00203;Água Clara;16076;665;16741
MS;50;00252;Alcinópolis;4335;202;4537
MS;50;00609;Amambai;37669;1656;39325
MS;50;00708;Anastácio;23504;603;24107
MS;50;00807;Anaurilândia;7468;185;7653
MS;50;00856;Angélica;10331;398;10729
MS;50;00906;Antônio João;9192;111;9303
MS;50;01003;Aparecida do Taboado;27588;86;27674
MS;50;01102;Aquidauana;45311;1492;46803
MS;50;01243;Aral Moreira;10726;22;10748
MS;50;01508;Bandeirantes;7613;327;7940
MS;50;01904;Bataguassu;22057;974;23031
MS;50;02001;Batayporã;10188;524;10712
MS;50;02100;Bela Vista;21196;417;21613
MS;50;02159;Bodoquena;8442;125;8567
MS;50;02209;Bonito;23010;649;23659
MS;50;02308;Brasilândia;11262;317;11579
MS;50;02407;Caarapó;29662;950;30612
MS;50;02605;Camapuã;13004;579;13583
MS;50;02704;Campo Grande;851964;45974;897938
MS;50;02803;Caracol;4933;103;5036
MS;50;02902;Cassilândia;20552;436;20988
MS;50;02951;Chapadão do Sul;30690;303;30993
MS;50;03108;Corguinho;4636;147;4783
MS;50;03157;Coronel Sapucaia;14023;138;14161
MS;50;03207;Corumbá;92966;3302;96268
MS;50;03256;Costa Rica;24899;1138;26037
MS;50;03306;Coxim;30714;1437;32151
MS;50;03454;Deodápolis;13493;170;13663
MS;50;03488;Dois Irmãos do Buriti;10830;270;11100
MS;50;03504;Douradina;5396;182;5578
MS;50;03702;Dourados;232627;10741;243368
MS;50;03751;Eldorado;11339;47;11386
MS;50;03801;Fátima do Sul;20283;326;20609
MS;50;03900;Figueirão;3351;188;3539
MS;50;04007;Glória de Dourados;10326;118;10444
MS;50;04106;Guia Lopes da Laguna;9704;235;9939
MS;50;04304;Iguatemi;13724;72;13796
MS;50;04403;Inocência;8095;309;8404
MS;50;04502;Itaporã;23576;561;24137
MS;50;04601;Itaquiraí;19130;303;19433
MS;50;04700;Ivinhema;26564;1257;27821
MS;50;04809;Japorã;8136;12;8148
MS;50;04908;Jaraguari;6852;287;7139
MS;50;05004;Jardim;23061;920;23981
MS;50;05103;Jateí;3500;86;3586
MS;50;05152;Juti;6556;173;6729
MS;50;05202;Ladário;20809;713;21522
MS;50;05251;Laguna Carapã;6706;93;6799
MS;50;05400;Maracaju;43543;1504;45047
MS;50;05608;Miranda;24816;720;25536
MS;50;05681;Mundo Novo;18781;412;19193
MS;50;05707;Naviraí;48527;1930;50457
MS;50;05806;Nioaque;13086;134;13220
MS;50;06002;Nova Alvorada do Sul;20805;1017;21822
MS;50;06200;Nova Andradina;46250;2313;48563
MS;50;06259;Novo Horizonte do Sul;4666;55;4721
MS;50;06275;Paraíso das Águas;5449;61;5510
MS;50;06309;Paranaíba;40332;625;40957
MS;50;06358;Paranhos;12884;37;12921
MS;50;06408;Pedro Gomes;6891;50;6941
MS;50;06606;Ponta Porã;88043;3974;92017
MS;50;06903;Porto Murtinho;12662;197;12859
MS;50;07109;Ribas do Rio Pardo;22119;1031;23150
MS;50;07208;Rio Brilhante;36168;1433;37601
MS;50;07307;Rio Negro;4654;187;4841
MS;50;07406;Rio Verde de Mato Grosso;18941;877;19818
MS;50;07505;Rochedo;4963;236;5199
MS;50;07554;Santa Rita do Pardo;6949;78;7027
MS;50;07695;São Gabriel do Oeste;28313;1266;29579
MS;50;07703;Sete Quedas;10994;0;10994
MS;50;07802;Selvíria;7811;331;8142
MS;50;07901;Sidrolândia;45620;1498;47118
MS;50;07935;Sonora;14253;263;14516
MS;50;07950;Tacuru;10715;93;10808
MS;50;07976;Taquarussu;3608;17;3625
MS;50;08008;Terenos;16859;779;17638
MS;50;08305;Três Lagoas;126289;5863;132152
MS;50;08404;Vicentina;6271;65;6336
MT;51;00102;Acorizal;4786;228;5014
MT;51;00201;Água Boa;28261;958;29219
MT;51;00250;Alta Floresta;56434;2179;58613
MT;51;00300;Alto Araguaia;17114;79;17193
MT;51;00359;Alto Boa Vista;5426;213;5639
MT;51;00409;Alto Garças;13019;33;13052
MT;51;00508;Alto Paraguai;7789;220;8009
MT;51;00607;Alto Taquari;10813;91;10904
MT;51;00805;Apiacás;8323;267;8590
MT;51;01001;Araguaiana;3698;97;3795
MT;51;01209;Araguainha;1010;0;1010
MT;51;01258;Araputanga;14093;693;14786
MT;51;01308;Arenápolis;10087;489;10576
MT;51;01407;Aripuanã;23694;932;24626
MT;51;01605;Barão de Melgaço;7223;30;7253
MT;51;01704;Barra do Bugres;28133;1270;29403
MT;51;01803;Barra do Garças;66147;3063;69210
MT;51;01852;Bom Jesus do Araguaia;6955;325;7280
MT;51;01902;Brasnorte;16516;488;17004
MT;51;02504;Cáceres;86093;3385;89478
MT;51;02603;Campinápolis;14994;353;15347
MT;51;02637;Campo Novo do Parecis;44211;1688;45899
MT;51;02678;Campo Verde;42544;2041;44585
MT;51;02686;Campos de Júlio;8495;327;8822
MT;51;02694;Canabrava do Norte;4399;86;4485
MT;51;02702;Canarana;24785;1058;25843
MT;51;02793;Carlinda;10215;117;10332
MT;51;02850;Castanheira;7223;283;7506
MT;51;03007;Chapada dos Guimarães;18210;780;18990
MT;51;03056;Cláudia;9314;279;9593
MT;51;03106;Cocalinho;5685;535;6220
MT;51;03205;Colíder;29953;1417;31370
MT;51;03254;Colniza;24702;1054;25756
MT;51;03304;Comodoro;17413;825;18238
MT;51;03353;Confresa;33878;1197;35075
MT;51;03361;Conquista D'Oeste;3612;148;3760
MT;51;03379;Cotriguaçu;10998;13;11011
MT;51;03403;Cuiabá;617420;33492;650912
MT;51;03437;Curvelândia;4693;210;4903
MT;51;03452;Denise;6968;46;7014
MT;51;03502;Diamantino;20792;1149;21941
MT;51;03601;Dom Aquino;7607;265;7872
MT;51;03700;Feliz Natal;10034;487;10521
MT;51;03809;Figueirópolis D'Oeste;3169;18;3187
MT;51;03858;Gaúcha do Norte;8254;392;8646
MT;51;03908;General Carneiro;5872;165;6037
MT;51;03957;Glória D'Oeste;2871;34;2905
MT;51;04104;Guarantã do Norte;29788;1236;31024
MT;51;04203;Guiratinga;10266;697;10963
MT;51;04500;Indiavaí;2173;40;2213
MT;51;04526;Ipiranga do Norte;7463;352;7815
MT;51;04542;Itanhangá;7262;277;7539
MT;51;04559;Itaúba;4871;149;5020
MT;51;04609;Itiquira;11704;532;12236
MT;51;04807;Jaciara;27488;1081;28569
MT;51;04906;Jangada;7326;100;7426
MT;51;05002;Jauru;8232;135;8367
MT;51;05101;Juara;33620;1286;34906
MT;51;05150;Juína;44452;1417;45869
MT;51;05176;Juruena;9885;328;10213
MT;51;05200;Juscimeira;10957;523;11480
MT;51;05234;Lambari D'Oeste;4701;89;4790
MT;51;05259;Lucas do Rio Verde;81044;2754;83798
MT;51;05309;Luciara;2400;109;2509
MT;51;05507;Vila Bela da Santíssima Trindade;15998;776;16774
MT;51;05580;Marcelândia;10929;468;11397
MT;51;05606;Matupá;19286;805;20091
MT;51;05622;Mirassol d'Oeste;25987;798;26785
MT;51;05903;Nobres;14802;690;15492
MT;51;06000;Nortelândia;5642;314;5956
MT;51;06109;Nossa Senhora do Livramento;12494;446;12940
MT;51;06158;Nova Bandeirantes;12988;647;13635
MT;51;06174;Nova Nazaré;4032;168;4200
MT;51;06182;Nova Lacerda;6238;432;6670
MT;51;06190;Nova Santa Helena;4072;167;4239
MT;51;06208;Nova Brasilândia;3731;201;3932
MT;51;06216;Nova Canaã do Norte;11167;540;11707
MT;51;06224;Nova Mutum;53922;1726;55648
MT;51;06232;Nova Olímpia;15677;675;16352
MT;51;06240;Nova Ubiratã;11029;469;11498
MT;51;06257;Nova Xavantina;23236;1109;24345
MT;51;06265;Novo Mundo;6212;308;6520
MT;51;06273;Novo Horizonte do Norte;3226;123;3349
MT;51;06281;Novo São Joaquim;6601;318;6919
MT;51;06299;Paranaíta;11300;371;11671
MT;51;06307;Paranatinga;25211;1212;26423
MT;51;06315;Novo Santo Antônio;1965;50;2015
MT;51;06372;Pedra Preta;17198;868;18066
MT;51;06422;Peixoto de Azevedo;31359;1355;32714
MT;51;06455;Planalto da Serra;3161;5;3166
MT;51;06505;Poconé;31202;15;31217
MT;51;06653;Pontal do Araguaia;6606;326;6932
MT;51;06703;Ponte Branca;2002;6;2008
MT;51;06752;Pontes e Lacerda;49575;2443;52018
MT;51;06778;Porto Alegre do Norte;13806;59;13865
MT;51;06802;Porto dos Gaúchos;5405;188;5593
MT;51;06828;Porto Esperidião;9946;258;10204
MT;51;06851;Porto Estrela;3099;125;3224
MT;51;07008;Poxoréu;22095;1188;23283
MT;51;07040;Primavera do Leste;82177;2969;85146
MT;51;07065;Querência;25742;1027;26769
MT;51;07107;São José dos Quatro Marcos;17531;318;17849
MT;51;07156;Reserva do Cabaçal;2073;49;2122
MT;51;07180;Ribeirão Cascalheira;9252;644;9896
MT;51;07198;Ribeirãozinho;2590;3;2593
MT;51;07206;Rio Branco;4412;123;4535
MT;51;07248;Santa Carmem;5157;217;5374
MT;51;07263;Santo Afonso;2412;107;2519
MT;51;07297;São José do Povo;2745;130;2875
MT;51;07305;São José do Rio Claro;14496;405;14901
MT;51;07354;São José do Xingu;5596;369;5965
MT;51;07404;São Pedro da Cipa;3990;201;4191
MT;51;07578;Rondolândia;3501;4;3505
MT;51;07602;Rondonópolis;235361;9536;244897
MT;51;07701;Rosário Oeste;14761;692;15453
MT;51;07743;Santa Cruz do Xingu;2453;208;2661
MT;51;07750;Salto do Céu;3567;112;3679
MT;51;07768;Santa Rita do Trivelato;3121;155;3276
MT;51;07776;Santa Terezinha;7385;211;7596
MT;51;07792;Santo Antônio do Leste;4016;83;4099
MT;51;07800;Santo Antônio do Leverger;14764;482;15246
MT;51;07859;São Félix do Araguaia;12727;885;13612
MT;51;07875;Sapezal;27819;1125;28944
MT;51;07883;Serra Nova Dourada;1714;86;1800
MT;51;07909;Sinop;188694;7373;196067
MT;51;07925;Sorriso;106584;4051;110635
MT;51;07941;Tabaporã;9386;426;9812
MT;51;07958;Tangará da Serra;101957;4477;106434
MT;51;08006;Tapurah;13986;384;14370
MT;51;08055;Terra Nova do Norte;10217;399;10616
MT;51;08105;Tesouro;2853;172;3025
MT;51;08204;Torixoréu;4011;153;4164
MT;51;08303;União do Sul;3766;72;3838
MT;51;08352;Vale de São Domingos;2822;82;2904
MT;51;08402;Várzea Grande;285847;13625;299472
MT;51;08501;Vera;12259;541;12800
MT;51;08600;Vila Rica;19787;101;19888
MT;51;08808;Nova Guarita;4432;156;4588
MT;51;08857;Nova Marilândia;3395;134;3529
MT;51;08907;Nova Maringá;5620;226;5846
MT;51;08956;Nova Monte Verde;8301;12;8313
GO;52;00050;Abadia de Goiás;18271;857;19128
GO;52;00100;Abadiânia;16681;547;17228
GO;52;00134;Acreúna;20753;815;21568
GO;52;00159;Adelândia;2252;45;2297
GO;52;00175;Água Fria de Goiás;4796;158;4954
GO;52;00209;Água Limpa;1834;17;1851
GO;52;00258;Águas Lindas de Goiás;216724;8947;225671
GO;52;00308;Alexânia;26110;898;27008
GO;52;00506;Aloândia;1913;60;1973
GO;52;00555;Alto Horizonte;5866;206;6072
GO;52;00605;Alto Paraíso de Goiás;9992;306;10298
GO;52;00803;Alvorada do Norte;8138;308;8446
GO;52;00829;Amaralina;3214;54;3268
GO;52;00852;Americano do Brasil;5177;82;5259
GO;52;00902;Amorinópolis;2921;86;3007
GO;52;01108;Anápolis;382427;16390;398817
GO;52;01207;Anhanguera;909;15;924
GO;52;01306;Anicuns;18191;312;18503
GO;52;01405;Aparecida de Goiânia;508355;19195;527550
GO;52;01454;Aparecida do Rio Doce;2785;122;2907
GO;52;01504;Aporé;4172;153;4325
GO;52;01603;Araçu;3670;129;3799
GO;52;01702;Aragarças;17586;804;18390
GO;52;01801;Aragoiânia;11759;131;11890
GO;52;02155;Araguapaz;7025;128;7153
GO;52;02353;Arenópolis;2924;22;2946
GO;52;02502;Aruanã;8278;22;8300
GO;52;02601;Aurilândia;3189;95;3284
GO;52;02809;Avelinópolis;2820;48;2868
GO;52;03104;Baliza;3344;7;3351
GO;52;03203;Barro Alto;9906;465;10371
GO;52;03302;Bela Vista de Goiás;33251;1194;34445
GO;52;03401;Bom Jardim de Goiás;7624;202;7826
GO;52;03500;Bom Jesus de Goiás;22958;1000;23958
GO;52;03559;Bonfinópolis;10192;104;10296
GO;52;03575;Bonópolis;3204;95;3299
GO;52;03609;Brazabrantes;3974;18;3992
GO;52;03807;Britânia;5453;242;5695
GO;52;03906;Buriti Alegre;10271;224;10495
GO;52;03939;Buriti de Goiás;2611;121;2732
GO;52;03962;Buritinópolis;3057;88;3145
GO;52;04003;Cabeceiras;7361;199;7560
GO;52;04102;Cachoeira Alta;11027;486;11513
GO;52;04201;Cachoeira de Goiás;1368;37;1405
GO;52;04250;Cachoeira Dourada;7516;266;7782
GO;52;04300;Caçu;13276;498;13774
GO;52;04409;Caiapônia;15743;764;16507
GO;52;04508;Caldas Novas;95561;3061;98622
GO;52;04557;Caldazinha;4313;194;4507
GO;52;04607;Campestre de Goiás;3608;147;3755
GO;52;04656;Campinaçu;3701;7;3708
GO;52;04706;Campinorte;12202;308;12510
GO;52;04805;Campo Alegre de Goiás;7293;129;7422
GO;52;04854;Campo Limpo de Goiás;7817;264;8081
GO;52;04904;Campos Belos;17854;254;18108
GO;52;04953;Campos Verdes;3830;175;4005
GO;52;05000;Carmo do Rio Verde;9697;13;9710
GO;52;05059;Castelândia;2961;24;2985
GO;52;05109;Catalão;110930;3497;114427
GO;52;05208;Caturaí;5004;180;5184
GO;52;05307;Cavalcante;9350;239;9589
GO;52;05406;Ceres;21253;793;22046
GO;52;05455;Cezarina;7794;296;8090
GO;52;05471;Chapadão do Céu;12397;473;12870
GO;52;05497;Cidade Ocidental;89826;1941;91767
GO;52;05513;Cocalzinho de Goiás;24292;724;25016
GO;52;05521;Colinas do Sul;4025;5;4030
GO;52;05703;Córrego do Ouro;2389;65;2454
GO;52;05802;Corumbá de Goiás;10240;322;10562
GO;52;05901;Corumbaíba;8927;237;9164
GO;52;06206;Cristalina;61203;1046;62249
GO;52;06305;Cristianópolis;3407;97;3504
GO;52;06404;Crixás;16505;560;17065
GO;52;06503;Cromínia;3735;148;3883
GO;52;06602;Cumari;2902;25;2927
GO;52;06701;Damianópolis;3662;108;3770
GO;52;06800;Damolândia;2660;64;2724
GO;52;06909;Davinópolis;1874;28;1902
GO;52;07105;Diorama;2062;0;2062
GO;52;07253;Doverlândia;6769;187;6956
GO;52;07352;Edealina;3880;121;4001
GO;52;07402;Edéia;11237;510;11747
GO;52;07501;Estrela do Norte;3110;95;3205
GO;52;07535;Faina;7042;28;7070
GO;52;07600;Fazenda Nova;5791;86;5877
GO;52;07808;Firminópolis;10138;281;10419
GO;52;07907;Flores de Goiás;13736;8;13744
GO;52;08004;Formosa;112062;3607;115669
GO;52;08103;Formoso;4605;55;4660
GO;52;08152;Gameleira de Goiás;3398;58;3456
GO;52;08301;Divinópolis de Goiás;4422;35;4457
GO;52;08400;Goianápolis;13609;358;13967
GO;52;08509;Goiandira;4939;29;4968
GO;52;08608;Goianésia;70686;3022;73708
GO;52;08707;Goiânia;1388070;49167;1437237
GO;52;08806;Goianira;70606;1310;71916
GO;52;08905;Goiás;23213;858;24071
GO;52;09101;Goiatuba;34292;1357;35649
GO;52;09150;Gouvelândia;4193;197;4390
GO;52;09200;Guapó;19339;206;19545
GO;52;09291;Guaraíta;2079;109;2188
GO;52;09408;Guarani de Goiás;3999;86;4085
GO;52;09457;Guarinos;2139;22;2161
GO;52;09606;Heitoraí;3325;29;3354
GO;52;09705;Hidrolândia;26722;1019;27741
GO;52;09804;Hidrolina;3389;156;3545
GO;52;09903;Iaciara;10173;411;10584
GO;52;09937;Inaciolândia;5713;241;5954
GO;52;09952;Indiara;17020;41;17061
GO;52;10000;Inhumas;50549;1655;52204
GO;52;10109;Ipameri;25099;449;25548
GO;52;10158;Ipiranga de Goiás;2871;48;2919
GO;52;10208;Iporá;34471;1213;35684
GO;52;10307;Israelândia;2490;70;2560
GO;52;10406;Itaberaí;43118;1616;44734
GO;52;10562;Itaguari;4874;89;4963
GO;52;10604;Itaguaru;4824;80;4904
GO;52;10802;Itajá;4207;173;4380
GO;52;10901;Itapaci;20565;522;21087
GO;52;11008;Itapirapuã;7708;294;8002
GO;52;11206;Itapuranga;24962;1151;26113
GO;52;11305;Itarumã;5830;271;6101
GO;52;11404;Itauçu;7633;103;7736
GO;52;11503;Itumbiara;103688;4282;107970
GO;52;11602;Ivolândia;2582;111;2693
GO;52;11701;Jandaia;6248;24;6272
GO;52;11800;Jaraguá;43617;1606;45223
GO;52;11909;Jataí;101312;4417;105729
GO;52;12006;Jaupaci;2849;75;2924
GO;52;12055;Jesúpolis;2123;0;2123
GO;52;12105;Joviânia;6869;290;7159
GO;52;12204;Jussara;18795;830;19625
GO;52;12253;Lagoa Santa;1340;50;1390
GO;52;12303;Leopoldo de Bulhões;8473;272;8745
GO;52;12501;Luziânia;203036;5689;208725
GO;52;12600;Mairipotaba;2540;21;2561
GO;52;12709;Mambaí;7852;272;8124
GO;52;12808;Mara Rosa;10500;200;10700
GO;52;12907;Marzagão;2724;34;2758
GO;52;12956;Matrinchã;4016;26;4042
GO;52;13004;Maurilândia;9888;416;10304
GO;52;13053;Mimoso de Goiás;2557;57;2614
GO;52;13087;Minaçu;26896;179;27075
GO;52;13103;Mineiros;68653;1420;70073
GO;52;13400;Moiporá;1634;51;1685
GO;52;13509;Monte Alegre de Goiás;6581;111;6692
GO;52;13707;Montes Claros de Goiás;8458;298;8756
GO;52;13756;Montividiu;11960;561;12521
GO;52;13772;Montividiu do Norte;3719;60;3779
GO;52;13806;Morrinhos;50460;891;51351
GO;52;13855;Morro Agudo de Goiás;2425;31;2456
GO;52;13905;Mossâmedes;4512;142;4654
GO;52;14002;Mozarlândia;14160;590;14750
GO;52;14051;Mundo Novo;5933;256;6189
GO;52;14101;Mutunópolis;3423;141;3564
GO;52;14408;Nazário;7865;324;8189
GO;52;14507;Nerópolis;31228;704;31932
GO;52;14606;Niquelândia;33705;1259;34964
GO;52;14705;Nova América;2335;2;2337
GO;52;14804;Nova Aurora;2097;4;2101
GO;52;14838;Nova Crixás;12234;581;12815
GO;52;14861;Nova Glória;8214;96;8310
GO;52;14879;Nova Iguaçu de Goiás;2931;79;3010
GO;52;14903;Nova Roma;3076;0;3076
GO;52;15009;Nova Veneza;9301;180;9481
GO;52;15207;Novo Brasil;3448;79;3527
GO;52;15231;Novo Gama;101384;2420;103804
GO;52;15256;Novo Planalto;3657;59;3716
GO;52;15306;Orizona;16226;173;16399
GO;52;15405;Ouro Verde de Goiás;3994;63;4057
GO;52;15504;Ouvidor;6971;229;7200
GO;52;15603;Padre Bernardo;33558;1409;34967
GO;52;15652;Palestina de Goiás;3055;77;3132
GO;52;15702;Palmeiras de Goiás;30974;884;31858
GO;52;15801;Palmelo;2231;28;2259
GO;52;15900;Palminópolis;3822;29;3851
GO;52;16007;Panamá;2344;111;2455
GO;52;16304;Paranaiguara;7272;335;7607
GO;52;16403;Paraúna;10506;153;10659
GO;52;16452;Perolândia;2948;16;2964
GO;52;16809;Petrolina de Goiás;9338;235;9573
GO;52;16908;Pilar de Goiás;2245;83;2328
GO;52;17104;Piracanjuba;23862;1021;24883
GO;52;17203;Piranhas;11683;29;11712
GO;52;17302;Pirenópolis;26142;548;26690
GO;52;17401;Pires do Rio;32193;180;32373
GO;52;17609;Planaltina;101443;3588;105031
GO;52;17708;Pontalina;18163;146;18309
GO;52;18003;Porangatu;42777;1540;44317
GO;52;18052;Porteirão;3987;83;4070
GO;52;18102;Portelândia;3247;33;3280
GO;52;18300;Posse;33795;1119;34914
GO;52;18391;Professor Jamil;3597;52;3649
GO;52;18508;Quirinópolis;46982;1465;48447
GO;52;18607;Rialma;11837;328;12165
GO;52;18706;Rianápolis;3834;146;3980
GO;52;18789;Rio Quente;3788;76;3864
GO;52;18805;Rio Verde;216498;9198;225696
GO;52;18904;Rubiataba;19685;103;19788
GO;52;19001;Sanclerlândia;7677;241;7918
GO;52;19100;Santa Bárbara de Goiás;5914;235;6149
GO;52;19209;Santa Cruz de Goiás;2927;75;3002
GO;52;19258;Santa Fé de Goiás;4767;184;4951
GO;52;19308;Santa Helena de Goiás;37707;785;38492
GO;52;19357;Santa Isabel;3433;105;3538
GO;52;19407;Santa Rita do Araguaia;5849;78;5927
GO;52;19456;Santa Rita do Novo Destino;2613;76;2689
GO;52;19506;Santa Rosa de Goiás;2736;84;2820
GO;52;19605;Santa Tereza de Goiás;3201;92;3293
GO;52;19704;Santa Terezinha de Goiás;10240;405;10645
GO;52;19712;Santo Antônio da Barra;4079;188;4267
GO;52;19738;Santo Antônio de Goiás;7133;253;7386
GO;52;19753;Santo Antônio do Descoberto;70445;1689;72134
GO;52;19803;São Domingos;9600;111;9711
GO;52;19902;São Francisco de Goiás;6362;16;6378
GO;52;20009;São João d'Aliança;13564;420;13984
GO;52;20058;São João da Paraúna;1703;71;1774
GO;52;20108;São Luís de Montes Belos;32713;1139;33852
GO;52;20157;São Luiz do Norte;4638;199;4837
GO;52;20207;São Miguel do Araguaia;21241;659;21900
GO;52;20264;São Miguel do Passa Quatro;4308;156;4464
GO;52;20280;São Patrício;2135;8;2143
GO;52;20405;São Simão;16337;683;17020
GO;52;20454;Senador Canedo;150828;4807;155635
GO;52;20504;Serranópolis;7755;272;8027
GO;52;20603;Silvânia;21702;543;22245
GO;52;20686;Simolândia;5620;122;5742
GO;52;20702;Sítio d'Abadia;2898;29;2927
GO;52;21007;Taquaral de Goiás;3971;55;4026
GO;52;21080;Teresina de Goiás;2669;32;2701
GO;52;21197;Terezópolis de Goiás;7697;247;7944
GO;52;21304;Três Ranchos;2827;94;2921
GO;52;21403;Trindade;137783;4648;142431
GO;52;21452;Trombas;3116;4;3120
GO;52;21502;Turvânia;4369;111;4480
GO;52;21551;Turvelândia;4844;141;4985
GO;52;21577;Uirapuru;2736;62;2798
GO;52;21601;Uruaçu;40874;1672;42546
GO;52;21700;Uruana;13689;40;13729
GO;52;21809;Urutaí;3528;25;3553
GO;52;21858;Valparaíso de Goiás;194225;4636;198861
GO;52;21908;Varjão;3614;102;3716
GO;52;22005;Vianópolis;14345;611;14956
GO;52;22054;Vicentinópolis;8592;176;8768
GO;52;22203;Vila Boa;4168;47;4215
GO;52;22302;Vila Propício;5594;221;5815
DF;53;00108;Brasília;2717524;99544;2817068
